CHR	原始拆分	替换拆分
的	白勹丶丶丶丶	白勹丶丶丶丶
一	笔一一一一一	笔一一一一一
是	是丨ㄋ一一一	是丨ㄋ一一一
不	不一丿丨丶丶	不一丿丨丶丶
了	了ㄋ丨丨丨丨	了ㄋ丨丨丨丨
在	土一丨一一	土一丨一一
人	人丿丶丶丶丶	人丿丶丶丶丶
有	石月丨ㄋ一一	石月丨ㄋ一一
我	我丿一丨一ㄋ	我丿一丨一ㄋ
他	亻也ㄋ丨ㄋㄋ	亻也ㄋ丨ㄋㄋ
这	文辶丶ㄋ丶丶	文辶丶ㄋ丶丶
个	人笔丨丨丨丨	人笔丨丨丨丨
们	亻门丶丨ㄋㄋ	亻门丶丨ㄋㄋ
中	中丨ㄋ一丨丨	中丨ㄋ一丨丨
来	夹来丨丿丶丶	夹来丨丿丶丶
上	上丨一一一一	上丨一一一一
大	大一丿丶丶丶	大一丿丶丶丶
为	笔力丶丶丶丶	笔力丶丶丶丶
和	禾口丨ㄋ一一	禾口丨ㄋ一一
国	口王丶丶丶丶	口王丶丶丶丶
地	土也ㄋ丨ㄋㄋ	土也ㄋ丨ㄋㄋ
到	至刂丨丨丨丨	至刂丨丨丨丨
以	以ㄋ丶丿丶丶	以ㄋ丶丿丶丶
说	讠𠮦丿ㄋㄋㄋ	讠兑丿ㄋㄋㄋ
时	日寸一丨丶丶	日寸一丨丶丶
要	西女ㄋ丿一一	西女ㄋ丿一一
就	京尢丶丶丶丶	京尢丶丶丶丶
出	山冂ㄋ丨丨丨	山冂ㄋ丨丨丨
会	人云一一ㄋ丶	人云一一ㄋ丶
可	可一丨ㄋ一丨	可一丨ㄋ一丨
也	也ㄋ丨ㄋㄋㄋ	也ㄋ丨ㄋㄋㄋ
你	亻尔丿ㄋ丨丿	亻尔丿ㄋ丨丿
对	双寸一丨丶丶	双寸一丨丶丶
生	生丿一一丨一	生丿一一丨一
能	厶月丿ㄋㄋㄋ	厶月丿ㄋㄋㄋ
而	而一丿丨ㄋ丨	而一丿丨ㄋ丨
子	子ㄋ丨一一一	子ㄋ丨一一一
那	刀耳ㄋ丨丨丨	刀耳ㄋ丨丨丨
得	彳旦一丨丶丶	彳旦一丨丶丶
于	于一一丨丨丨	于一一丨丨丨
着	羊目丨ㄋ一一	羊目丨ㄋ一一
下	下一丨丶丶丶	下一丨丶丶丶
自	自丿丨ㄋ一一	自丿丨ㄋ一一
之	之丶ㄋ丶丶丶	之丶ㄋ丶丶丶
年	㐄一丨一丨	年一丨一丨
过	寸辶丶ㄋ丶丶	寸辶丶ㄋ丶丶
发	发ㄋ丿ㄋ丶丶	发ㄋ丿ㄋ丶丶
后	广鬲一丨ㄋ一	广鬲一丨ㄋ一
作	亻乍丿一丨一	亻乍丿一丨一
里	田丨ㄋ一一丨	田丨ㄋ一一丨
用	甬丿ㄋ一一丨	甬丿ㄋ一一丨
道	䒑自丶ㄋ丶丶	首自丶ㄋ丶丶
行	彳于一一丨丨	彳于一一丨丨
所	广匚丿丿一丨	广匚丿丿一丨
然	歹犬丶丶丶丶	歹犬丶丶丶丶
家	宀豕一丿ㄋ丿	宀豕一丿ㄋ丿
种	禾中丨ㄋ一丨	禾中丨ㄋ一丨
事	鬲聿ㄋ一一丨	鬲聿ㄋ一一丨
成	戊㇉ㄋㄋㄋㄋ	戊Zㄋㄋㄋㄋ
方	方丶一ㄋ丿丿	方丶一ㄋ丿丿
多	歹歹丿ㄋ丶丶	歹歹丿ㄋ丶丶
经	纟轻ㄋ丶一丨	纟轻ㄋ丶一丨
么	笔厶ㄋ丶丶丶	笔厶ㄋ丶丶丶
去	去一丨一ㄋ丶	去一丨一ㄋ丶
法	氵去一丨一ㄋ	氵去一丨一ㄋ
学	子ㄋ丨一一	子ㄋ丨一一
如	女口丨ㄋ一一	女口丨ㄋ一一
都	者耳ㄋ丨丨丨	者耳ㄋ丨丨丨
同	冂鬲一丨ㄋ一	冂鬲一丨ㄋ一
现	王见丿ㄋㄋㄋ	王见丿ㄋㄋㄋ
当	尹ㄋ一一一	尹ㄋ一一一
没	氵殳丿ㄋㄋ丶	氵殳丿ㄋㄋ丶
动	云力ㄋ丿丿丿	云力ㄋ丿丿丿
面	面一丿丨ㄋ丨	面一丿丨ㄋ丨
起	走巴ㄋ一ㄋㄋ	走巴ㄋ一ㄋㄋ
看	手目丨ㄋ一一	手目丨ㄋ一一
定	定丶丶ㄋ一丨	定丶丶ㄋ一丨
天	天一一丿丶丶	天一一丿丶丶
分	分丿丶ㄋ丿丿	分丿丶ㄋ丿丿
还	不辶丶ㄋ丶丶	不辶丶ㄋ丶丶
进	二辶丶ㄋ丶丶	二辶丶ㄋ丶丶
好	女子ㄋ丨一一	女子ㄋ丨一一
小	小丨丿丶丶丶	小丨丿丶丶丶
部	立口ㄋ丨丨丨	立口ㄋ丨丨丨
其	其一丨丨一一	其一丨丨一一
些	此二一一一一	此二一一一一
主	主丶一一丨一	主丶一一丨一
样	木羊丶丿一一	木羊丶丿一一
理	王田丨ㄋ一一	王田丨ㄋ一一
心	心丶ㄋ丶丶丶	心丶ㄋ丶丶丶
她	女也ㄋ丨ㄋㄋ	女也ㄋ丨ㄋㄋ
本	木笔一一一一	木笔一一一一
前	前丶丿一丨ㄋ	前丶丿一丨ㄋ
开	开一一丿丨丨	开一一丿丨丨
但	亻旦丨ㄋ一一	亻旦丨ㄋ一一
因	因丨ㄋ一丿丶	因丨ㄋ一丿丶
只	口八丿丶丶丶	口八丿丶丶丶
从	从丿丶丿丶丶	从丿丶丿丶丶
想	相心丶ㄋ丶丶	相心丶ㄋ丶丶
实	宀冫一丿丶丶	宀冫一丿丶丶
日	日丨ㄋ一一一	日丨ㄋ一一一
军	冖车一ㄋ一丨	冖车一ㄋ一丨
者	者一丨一丿丨	者一丨一丿丨
意	音心丶ㄋ丶丶	音心丶ㄋ丶丶
无	笔尢一丿ㄋㄋ	笔尢一丿ㄋㄋ
力	力ㄋ丿丿丿丿	力ㄋ丿丿丿丿
它	宀七丿ㄋㄋㄋ	宀七丿ㄋㄋㄋ
与	与笔一一一一	与笔一一一一
长	长丿一ㄋ丶丶	长丿一ㄋ丶丶
把	扌巴ㄋ丨一ㄋ	扌巴ㄋ丨一ㄋ
机	木几丿ㄋㄋㄋ	木几丿ㄋㄋㄋ
十	十一丨丨丨丨	十一丨丨丨丨
民	民ㄋ一ㄋ一ㄋ	民ㄋ一ㄋ一ㄋ
第	弓丨丿丿丿	弓丨丿丿丿
公	公丿丶ㄋ丶丶	公丿丶ㄋ丶丶
此	此丨一丨一丿	此丨一丨一丿
已	巴ㄋ一ㄋㄋㄋ	巴ㄋ一ㄋㄋㄋ
工	工一丨一一一	工一丨一一一
使	亻鬲丿丶丶丶	亻鬲丿丶丶丶
情	忄青一一丨一	忄青一一丨一
明	日月丿ㄋ一一	日月丿ㄋ一一
性	忄生丿一一丨	忄生丿一一丨
知	矢口丨ㄋ一一	矢口丨ㄋ一一
全	人王一一丨一	人王一一丨一
三	三一一一一一	三一一一一一
又	双ㄋ丶丶丶丶	双ㄋ丶丶丶丶
关	䒑大一丿丶丶	首大一丿丶丶
点	占水丶丶丶丶	占水丶丶丶丶
正	正一丨一丨一	正一丨一丨一
业	业丨丨丶丿一	业丨丨丶丿一
外	歹卜丨丶丶丶	歹卜丨丶丶丶
将	北歹一丨丶丶	北歹一丨丶丶
两	丙从丿丶丿丶	丙从丿丶丿丶
高	口丨ㄋ一一	口丨ㄋ一一
间	门日丨ㄋ一一	门日丨ㄋ一一
由	甲丨ㄋ一丨一	甲丨ㄋ一丨一
问	门口丨ㄋ一一	门口丨ㄋ一一
很	彳艮ㄋ一一ㄋ	彳艮ㄋ一一ㄋ
最	日耳ㄋ丶丶丶	日耳ㄋ丶丶丶
重	舌田丨ㄋ一一	舌田丨ㄋ一一
并	䒑开一丿丨丨	首开一丿丨丨
物	牛勿丿ㄋ丿丿	牛勿丿ㄋ丿丿
手	手丿一一丨丨	手丿一一丨丨
应	广丶丶丿一	广丶丶丿一
战	占戋一ㄋ丿丶	占戋一ㄋ丿丶
向	口丨ㄋ一一	口丨ㄋ一一
头	冫大一丿丶丶	冫大一丿丶丶
文	文丶一丿丶丶	文丶一丿丶丶
体	亻木一一一一	亻木一一一一
政	正文丿一丿丶	正文丿一丿丶
美	羊大一丿丶丶	羊大一丿丶丶
相	相一丨丿丶丨	相一丨丿丶丨
见	见丨ㄋ丿ㄋㄋ	见丨ㄋ丿ㄋㄋ
被	衤皮ㄋ丿丨ㄋ	衤皮ㄋ丿丨ㄋ
利	禾刂丨丨丨丨	禾刂丨丨丨丨
什	亻十一丨丨丨	亻十一丨丨丨
二	二一一一一一	二一一一一一
等	土一丨丶丶	土一丨丶丶
产	立广一丿丿丿	立广一丿丿丿
或	戋口一一一一	戋口一一一一
新	立木丿丿一丨	立木丿丿一丨
己	巴ㄋ一ㄋㄋㄋ	巴ㄋ一ㄋㄋㄋ
制	巾丨丨丨丨	巾丨丨丨丨
身	身丿丨ㄋ一一	身丿丨ㄋ一一
果	日木一丨丿丶	日木一丨丿丶
加	加ㄋ丿丨ㄋ一	加ㄋ丿丨ㄋ一
西	西一丨ㄋ丿ㄋ	西一丨ㄋ丿ㄋ
斯	其丘丿丿一丨	其丘丿丿一丨
月	月丿ㄋ一一一	月丿ㄋ一一一
话	讠舌丿一丨丨	讠舌丿一丨丨
合	合丿丶一丨ㄋ	合丿丶一丨ㄋ
回	回丨ㄋ丨ㄋ一	回丨ㄋ丨ㄋ一
特	牛土一丨丶丶	牛土一丨丶丶
代	代丿丨一ㄋ丶	代丿丨一ㄋ丶
内	内丨ㄋ丿丶丶	内丨ㄋ丿丶丶
信	亻讠丶一一一	亻讠丶一一一
表	丰衣丿ㄋ丿丶	丰衣丿ㄋ丿丶
化	化丿丨丿ㄋㄋ	化丿丨丿ㄋㄋ
老	者七丿ㄋㄋㄋ	者七丿ㄋㄋㄋ
给	纟合丿丶一丨	纟合丿丶一丨
世	甘乙ㄋㄋㄋㄋ	甘乙ㄋㄋㄋㄋ
位	亻立丶一丶丿	亻立丶一丶丿
次	次丶一丿ㄋ丿	次丶一丿ㄋ丿
度	度双ㄋ丶丶丶	度双ㄋ丶丶丶
门	门丶丨ㄋㄋㄋ	门丶丨ㄋㄋㄋ
任	亻王丿一丨一	亻王丿一丨一
常	巾丨ㄋ丨丨	巾丨ㄋ丨丨
先	先丿一丨一丿	先丿一丨一丿
海	氵ㄋㄋ丶一	氵ㄋㄋ丶一
通	甬辶丶ㄋ丶丶	甬辶丶ㄋ丶丶
教	者子丿一丿丶	者子丿一丿丶
儿	儿丿ㄋㄋㄋㄋ	儿丿ㄋㄋㄋㄋ
原	广白丨丿丶丶	广白丨丿丶丶
东	车小丨丿丶丶	车小丨丿丶丶
声	土尸ㄋ丨一丿	土尸ㄋ丨一丿
提	扌是丨ㄋ一一	扌是丨ㄋ一一
立	立丶一丶丿一	立丶一丶丿一
及	及丿ㄋ丶丶丶	及丿ㄋ丶丶丶
比	比一ㄋ丿ㄋㄋ	比一ㄋ丿ㄋㄋ
员	口贝丨ㄋ丿丶	口贝丨ㄋ丿丶
解	角刀丿一一丨	角刀丿一一丨
水	水丨ㄋ丿丶丶	水丨ㄋ丿丶丶
名	歹口丨ㄋ一一	歹口丨ㄋ一一
真	直八丿丶丶丶	直八丿丶丶丶
论	讠仑丿丶丿ㄋ	讠仑丿丶丿ㄋ
处	文卜丨丶丶丶	文卜丨丶丶丶
走	走一丨一丨一	走一丨一丨一
义	义丶丿丶丶丶	义丶丿丶丶丶
各	各丿ㄋ丶丨ㄋ	各丿ㄋ丶丨ㄋ
入	入丿丶丶丶丶	入丿丶丶丶丶
几	几丿ㄋㄋㄋㄋ	几丿ㄋㄋㄋㄋ
口	口丨ㄋ一一一	口丨ㄋ一一一
认	讠人丿丶丶丶	讠人丿丶丶丶
条	文木一丨丿丶	文木一丨丿丶
平	平一丶丿一丨	平一丶丿一丨
系	笔糸ㄋㄋ丶丨	笔糸ㄋㄋ丶丨
气	气丿一一ㄋㄋ	气丿一一ㄋㄋ
题	是页一丿丨ㄋ	是页一丿丨ㄋ
活	氵舌丿一丨丨	氵舌丿一丨丨
尔	尔丿ㄋ丨丿丶	尔丿ㄋ丨丿丶
更	更一丨ㄋ一一	更一丨ㄋ一一
别	口力丨丨丨丨	口力丨丨丨丨
打	扌于一丨丨丨	扌于一丨丨丨
女	女ㄋ丿一一一	女ㄋ丿一一一
变	亦双ㄋ丶丶丶	亦双ㄋ丶丶丶
四	口儿丿ㄋㄋㄋ	口儿丿ㄋㄋㄋ
神	衤日丨丨丨丨	衤日丨丨丨丨
总	𠮦心丶ㄋ丶丶	兑心丶ㄋ丶丶
何	亻可一丨ㄋ一	亻可一丨ㄋ一
电	日乙ㄋㄋㄋㄋ	日乙ㄋㄋㄋㄋ
数	米女丿一丿丶	米女丿一丿丶
安	宀女ㄋ丿一一	宀女ㄋ丿一一
少	少丨丿丶丿丿	少丨丿丶丿丿
报	扌卩ㄋ丶丶丶	扌卩ㄋ丶丶丶
才	才一丨丿丿丿	才一丨丿丿丿
结	纟吉一丨一丨	纟吉一丨一丨
反	广双ㄋ丶丶丶	广双ㄋ丶丶丶
受	双ㄋ丶丶丶	双ㄋ丶丶丶
目	目丨ㄋ一一一	目丨ㄋ一一一
太	大笔丶丶丶丶	大笔丶丶丶丶
量	旦田丨ㄋ一一	旦田丨ㄋ一一
再	丙土一丨一一	丙土一丨一一
感	戊鬲丶ㄋ丶丶	戊鬲丶ㄋ丶丶
建	聿辶ㄋ丶丶丶	聿辶ㄋ丶丶丶
务	文力ㄋ丿丿丿	文力ㄋ丿丿丿
做	亻古丿一丿丶	亻古丿一丿丶
接	扌立ㄋ丿一一	扌立ㄋ丿一一
必	心笔丿丿丿丿	心笔丿丿丿丿
场	土㇉丿丿丿丿	土Z丿丿丿丿
件	亻牛丿一一丨	亻牛丿一一丨
计	讠十一丨丨丨	讠十一丨丨丨
管	宀丨ㄋ一ㄋ	宀丨ㄋ一ㄋ
期	其月丿ㄋ一一	其月丿ㄋ一一
市	亠巾丨ㄋ丨丨	亠巾丨ㄋ丨丨
直	直一丨丨ㄋ	直一丨丨ㄋ
德	彳十丨ㄋ丨丨	彳十丨ㄋ丨丨
资	次贝丨ㄋ丿丶	次贝丨ㄋ丿丶
命	亼口ㄋ丨丨丨	亼口ㄋ丨丨丨
山	山丨ㄋ丨丨丨	山丨ㄋ丨丨丨
金	金丿丶一一丨	金丿丶一一丨
指	扌七丨ㄋ一一	扌七丨ㄋ一一
克	古儿丿ㄋㄋㄋ	古儿丿ㄋㄋㄋ
许	讠一丨丨丨	讠一丨丨丨
统	纟亡丿ㄋㄋㄋ	纟亡丿ㄋㄋㄋ
区	区一丿丶ㄋㄋ	区一丿丶ㄋㄋ
保	亻呆丨ㄋ一一	亻呆丨ㄋ一一
至	至一ㄋ丶一丨	至一ㄋ丶一丨
队	耳人丿丶丶丶	耳人丿丶丶丶
形	开川丿丿丿丿	开川丿丿丿丿
社	衤土一丨一一	衤土一丨一一
便	亻更一丨ㄋ一	亻更一丨ㄋ一
空	穴工一丨一一	穴工一丨一一
决	冫匚丿丶丶丶	冫匚丿丶丶丶
治	氵厶丨ㄋ一一	氵厶丨ㄋ一一
展	尸共ㄋ丿丶丶	尸共ㄋ丿丶丶
马	马ㄋㄋ一一一	马ㄋㄋ一一一
科	禾冫一丨丨丨	禾冫一丨丨丨
司	㇉鬲一丨ㄋ一	Z鬲一丨ㄋ一
五	五一丨ㄋ一一	五一丨ㄋ一一
基	其土一丨一一	其土一丨一一
眼	目艮ㄋ一一ㄋ	目艮ㄋ一一ㄋ
书	㇉㇉丨丶丶丶	ZZ丨丶丶丶
非	非丨一一一丨	非丨一一一丨
则	贝刂丨丨丨丨	贝刂丨丨丨丨
听	口丘丿丿一丨	口丘丿丿一丨
白	白丿丨ㄋ一一	白丿丨ㄋ一一
却	去卩ㄋ丨丨丨	去卩ㄋ丨丨丨
界	田人丿丨丨丨	田人丿丨丨丨
达	大辶丶ㄋ丶丶	大辶丶ㄋ丶丶
光	光丨丶丿一丿	光丨丶丿一丿
放	方文丿一丿丶	方文丿一丿丶
强	弓口丨ㄋ一丨	弓口丨ㄋ一丨
即	卩ㄋ丨丨丨	卩ㄋ丨丨丨
像	亻象丿ㄋ丨ㄋ	亻象丿ㄋ丨ㄋ
难	双隹丿丨丶一	双隹丿丨丶一
且	目丨ㄋ一一一	目丨ㄋ一一一
权	木双ㄋ丶丶丶	木双ㄋ丶丶丶
思	田心丶ㄋ丶丶	田心丶ㄋ丶丶
王	王一一丨一一	王一一丨一一
象	象丿ㄋ丨ㄋ一	象丿ㄋ丨ㄋ一
完	宀元一一丿ㄋ	宀元一一丿ㄋ
设	讠殳丿ㄋㄋ丶	讠殳丿ㄋㄋ丶
式	戋工一丨一一	戋工一丨一一
色	鱼巴ㄋ丨一ㄋ	鱼巴ㄋ丨一ㄋ
路	各丿ㄋ丶丨	各丿ㄋ丶丨
记	讠巴ㄋ一ㄋㄋ	讠巴ㄋ一ㄋㄋ
南	十冂丶丿一一	十冂丶丿一一
品	口吅丨ㄋ一丨	口吅丨ㄋ一丨
住	亻主丶一一丨	亻主丶一一丨
告	告丿一丨一丨	告丿一丨一丨
类	米大一丿丶丶	米大一丿丶丶
求	求一丨丶一丿	求一丨丶一丿
据	扌尸一丨丨ㄋ	扌尸一丨丨ㄋ
程	禾口一一丨一	禾口一一丨一
北	北丨一一丿ㄋ	北丨一一丿ㄋ
边	力辶丶ㄋ丶丶	力辶丶ㄋ丶丶
死	歹七丿ㄋㄋㄋ	歹七丿ㄋㄋㄋ
张	弓长丿一ㄋ丶	弓长丿一ㄋ丶
该	讠亥丶一ㄋ丿	讠亥丶一ㄋ丿
交	六乂丿丶丶丶	六乂丿丶丶丶
规	夫见丨ㄋ丿ㄋ	夫见丨ㄋ丿ㄋ
万	力一ㄋ丿丿丿	力一ㄋ丿丿丿
取	耳双ㄋ丶丶丶	耳双ㄋ丶丶丶
拉	扌立丶一丶丿	扌立丶一丶丿
格	木各丿ㄋ丶丨	木各丿ㄋ丶丨
望	亡月一一丨一	亡月一一丨一
觉	见丨ㄋ丿ㄋ	见丨ㄋ丿ㄋ
术	木笔丶丶丶丶	木笔丶丶丶丶
领	令页一丿丨ㄋ	令页一丿丨ㄋ
共	共一丨丨一	共一丨丨一
确	石角丿ㄋ丿ㄋ	石角丿ㄋ丿ㄋ
传	亻二ㄋ丶丶丶	亻二ㄋ丶丶丶
师	刂笔丨ㄋ丨丨	刂笔丨ㄋ丨丨
观	双见丨ㄋ丿ㄋ	双见丨ㄋ丿ㄋ
清	氵青一一丨一	氵青一一丨一
今	令丿丶丶ㄋㄋ	令丿丶丶ㄋㄋ
切	七刀ㄋ丿丿丿	七刀ㄋ丿丿丿
院	耳宀一一丿ㄋ	耳宀一一丿ㄋ
让	讠上丨一一一	讠上丨一一一
识	讠口丿丶丶丶	讠口丿丶丶丶
候	亻匚丿一一丿	亻匚丿一一丿
带	艹冖丨ㄋ丨丨	艹冖丨ㄋ丨丨
导	巴寸一丨丶丶	巴寸一丨丶丶
争	争丿ㄋㄋ一一	争丿ㄋㄋ一一
运	云辶丶ㄋ丶丶	云辶丶ㄋ丶丶
笑	天丿一丿丶	天丿一丿丶
飞	乙冫丿丶丶丶	乙冫丿丶丶丶
风	几乂丿丶丶丶	几乂丿丶丶丶
步	止小丨丿丿丿	止小丨丿丿丿
改	巴文丿一丿丶	巴文丿一丿丶
收	丩文丿一丿丶	丩文丿一丿丶
根	木艮ㄋ一一ㄋ	木艮ㄋ一一ㄋ
干	舌一一丨丨丨	舌一一丨丨丨
造	告辶丶ㄋ丶丶	告辶丶ㄋ丶丶
言	讠丶一一一丨	讠丶一一一丨
联	耳䒑一丿丶丶	耳首一丿丶丶
持	扌土一丨丶丶	扌土一丨丶丶
组	纟目丨ㄋ一一	纟目丨ㄋ一一
每	母ㄋㄋ丶一	母ㄋㄋ丶一
济	氵文丿丨丨丨	氵文丿丨丨丨
车	车一ㄋ一丨丨	车一ㄋ一丨丨
亲	立木一丨丿丶	立木一丨丿丶
极	木及丿ㄋ丶丶	木及丿ㄋ丶丶
林	林一丨丿丶一	林一丨丿丶一
服	月卩ㄋ丶丶丶	月卩ㄋ丶丶丶
快	忄匚丿丶丶丶	忄匚丿丶丶丶
办	力八丿丶丶丶	力八丿丶丶丶
议	讠义丶丿丶丶	讠义丶丿丶丶
往	彳主丶一一丨	彳主丶一一丨
元	元一一丿ㄋㄋ	元一一丿ㄋㄋ
英	艹冂一丿丶丶	艹冂一丿丶丶
士	土一丨一一一	土一丨一一一
证	讠正一丨一丨	讠正一丨一丨
近	丘辶丶ㄋ丶丶	丘辶丶ㄋ丶丶
失	笔夫一一丿丶	笔夫一一丿丶
转	车二ㄋ丶丶丶	车二ㄋ丶丶丶
夫	夫一一丿丶丶	夫一一丿丶丶
令	令丿丶丶ㄋ丶	令丿丶丶ㄋ丶
准	冫隹丿丨丶一	冫隹丿丨丶一
布	石巾丨ㄋ丨丨	石巾丨ㄋ丨丨
始	女厶丨ㄋ一一	女厶丨ㄋ一一
怎	乍心丶ㄋ丶丶	乍心丶ㄋ丶丶
呢	口尸丿ㄋㄋㄋ	口尸丿ㄋㄋㄋ
存	子ㄋ丨一一	子ㄋ丨一一
未	未丨丿丶丶丶	未丨丿丶丶丶
远	元辶丶ㄋ丶丶	元辶丶ㄋ丶丶
叫	口丩ㄋ丨丨丨	口丩ㄋ丨丨丨
台	厶口丨ㄋ一一	厶口丨ㄋ一一
单	单丶丿丨ㄋ一	单丶丿丨ㄋ一
影	日京丿丿丿丿	日京丿丿丿丿
具	目八丿丶丶丶	目八丿丶丶丶
罗	四歹丿ㄋ丶丶	四歹丿ㄋ丶丶
字	宀子ㄋ丨一一	宀子ㄋ丨一一
爱	石ㄋ丶丶丶	石ㄋ丶丶丶
击	土冂ㄋ丨丨丨	土冂ㄋ丨丨丨
流	氵亡丿丨ㄋㄋ	氵亡丿丨ㄋㄋ
备	文田丨ㄋ一丨	文田丨ㄋ一丨
兵	丘八丿丶丶丶	丘八丿丶丶丶
连	车辶丶ㄋ丶丶	车辶丶ㄋ丶丶
调	讠冂一丨一丨	讠冂一丨一丨
深	氵冖丿丶一丨	氵冖丿丶一丨
商	立冂丿丶丨ㄋ	立冂丿丶丨ㄋ
算	目一丿丨丨	目一丿丨丨
质	广十丨ㄋ丿丶	广十丨ㄋ丿丶
团	口㇉一丨丿丿	口Z一丨丿丿
集	隹木一丨丿丶	隹木一丨丿丶
百	笔白丿丨ㄋ一	笔白丿丨ㄋ一
需	而一丿丨ㄋ	而一丿丨ㄋ
价	亻人丿丨丨丨	亻人丿丨丨丨
花	艹化丿丨丿ㄋ	艹化丿丨丿ㄋ
党	儿丿ㄋㄋㄋ	儿丿ㄋㄋㄋ
华	化十一丨丨丨	化十一丨丨丨
城	土戊ㄋㄋㄋㄋ	土戊ㄋㄋㄋㄋ
石	石一丿丨ㄋ一	石一丿丨ㄋ一
级	纟及丿ㄋ丶丶	纟及丿ㄋ丶丶
整	束文一丨一丨	束文一丨一丨
府	广亻一丨丶丶	广亻一丨丶丶
离	㐫内丨ㄋㄋ丶	离内丨ㄋㄋ丶
况	冫口丿ㄋㄋㄋ	冫口丿ㄋㄋㄋ
亚	亚一丨丨丶丿	亚一丨丨丶丿
请	讠青一一丨一	讠青一一丨一
技	扌十ㄋ丶丶丶	扌十ㄋ丶丶丶
际	耳示一一丨丿	耳示一一丨丿
约	纟勹丶丶丶丶	纟勹丶丶丶丶
示	示一一丨丿丶	示一一丨丿丶
复	日丿ㄋ丶丶	日丿ㄋ丶丶
病	疒丙丿丶丿丶	疒丙丿丶丿丶
息	自心丶ㄋ丶丶	自心丶ㄋ丶丶
究	穴九丿ㄋㄋㄋ	穴九丿ㄋㄋㄋ
线	纟戋一一ㄋ丿	纟戋一一ㄋ丿
似	亻以ㄋ丶丿丶	亻以ㄋ丶丿丶
官	宀吅丨ㄋ一ㄋ	宀吅丨ㄋ一ㄋ
火	火丶丿丿丶丶	火丶丿丿丶丶
断	米乙丿丿一丨	米乙丿丿一丨
精	米青一一丨一	米青一一丨一
满	氵艹一丨ㄋ丿	氵艹一丨ㄋ丿
支	十双ㄋ丶丶丶	十双ㄋ丶丶丶
视	衤见丨ㄋ丿ㄋ	衤见丨ㄋ丿ㄋ
消	氵丨ㄋ一一	氵丨ㄋ一一
越	走戊一ㄋㄋ丿	走戊一ㄋㄋ丿
器	吅犬丨ㄋ一丨	吅犬丨ㄋ一丨
容	穴人丨ㄋ一一	穴人丨ㄋ一一
照	日刀丨ㄋ一丶	日刀丨ㄋ一丶
须	川页一丿丨ㄋ	川页一丿丨ㄋ
九	九丿ㄋㄋㄋㄋ	九丿ㄋㄋㄋㄋ
增	土曾丶丿丨ㄋ	土曾丶丿丨ㄋ
研	石开一一丿丨	石开一一丿丨
写	冖与一一一一	冖与一一一一
称	禾尔丿ㄋ丨丿	禾尔丿ㄋ丨丿
企	人止丨一丨一	人止丨一丨一
八	八丿丶丶丶丶	八丿丶丶丶丶
功	工力ㄋ丿丿丿	工力ㄋ丿丿丿
吗	口马ㄋㄋ一一	口马ㄋㄋ一一
包	勹巴ㄋ一ㄋㄋ	勹巴ㄋ一ㄋㄋ
片	片丿丨一ㄋㄋ	片丿丨一ㄋㄋ
史	口乂丿丶丶丶	口乂丿丶丶丶
委	禾女ㄋ丿一一	禾女ㄋ丿一一
乎	乎丿丶丿一丨	乎丿丶丿一丨
查	木旦丨ㄋ一一	木旦丨ㄋ一一
轻	车轻ㄋ丶一丨	车轻ㄋ丶一丨
易	日勿丿ㄋ丿丿	日勿丿ㄋ丿丿
早	日十一丨丨丨	日十一丨丨丨
曾	曾丶丿丨ㄋ丨	曾丶丿丨ㄋ丨
除	耳亼一丨丿丶	耳亼一丨丿丶
农	农丶ㄋ丿ㄋ丿	农丶ㄋ丿ㄋ丿
找	扌戋一ㄋ丿丶	扌戋一ㄋ丿丶
装	北土丶一丿ㄋ	北土丶一丿ㄋ
广	广丶一丿丿丿	广丶一丿丿丿
显	日业丨丨丶丿	日业丨丨丶丿
吧	口巴ㄋ丨一ㄋ	口巴ㄋ丨一ㄋ
阿	耳可一丨ㄋ一	耳可一丨ㄋ一
李	木子ㄋ丨一一	木子ㄋ丨一一
标	木示一一丨丿	木示一一丨丿
谈	讠火丶丿丿丶	讠火丶丿丿丶
吃	口ㄋㄋㄋㄋ	口ㄋㄋㄋㄋ
图	口文丶丶丶丶	口文丶丶丶丶
念	令心丶ㄋ丶丶	令心丶ㄋ丶丶
六	六丶一丿丶丶	六丶一丿丶丶
引	弓笔丨丨丨丨	弓笔丨丨丨丨
历	广力ㄋ丿丿丿	广力ㄋ丿丿丿
首	䒑自丿丨ㄋ一	首自丿丨ㄋ一
医	匚矢丿一一丿	匚矢丿一一丿
局	尸㇉丨ㄋ一一	尸Z丨ㄋ一一
突	穴犬一丿丶丶	穴犬一丿丶丶
专	二㇉丶丶丶丶	二Z丶丶丶丶
费	弓刂丨ㄋ丿丶	弓刂丨ㄋ丿丶
号	口丂一ㄋㄋㄋ	口丂一ㄋㄋㄋ
尽	尺冫丶丶丶丶	尺冫丶丶丶丶
另	口力ㄋ丿丿丿	口力ㄋ丿丿丿
周	冂吉一丨一丨	冂吉一丨一丨
较	车六丿丶丶丶	车六丿丶丶丶
注	氵主丶一一丨	氵主丶一一丨
语	讠五丨ㄋ一一	讠五丨ㄋ一一
仅	亻双ㄋ丶丶丶	亻双ㄋ丶丶丶
考	者与一ㄋㄋㄋ	者与一ㄋㄋㄋ
落	落各丿ㄋ丶丨	落各丿ㄋ丶丨
青	青一一丨一丨	青一一丨一丨
随	耳石丿ㄋ一一	耳石丿ㄋ一一
选	先辶丶ㄋ丶丶	先辶丶ㄋ丶丶
列	歹刂丨丨丨丨	歹刂丨丨丨丨
武	笔戋丨一丨一	笔戋丨一丨一
红	纟工一丨一一	纟工一丨一一
响	口丨ㄋ一一	口丨ㄋ一一
虽	口虫丨ㄋ一丨	口虫丨ㄋ一丨
推	扌隹丿丨丶一	扌隹丿丨丶一
势	执力ㄋ丿丿丿	执力ㄋ丿丿丿
参	厶川丿丿丿丿	厶川丿丿丿丿
希	乂巾丨ㄋ丨丨	乂巾丨ㄋ丨丨
古	古一丨丨ㄋ一	古一丨丨ㄋ一
众	人从丿丶丿丶	人从丿丶丿丶
构	木勹ㄋ丶丶丶	木勹ㄋ丶丶丶
房	户方丶一ㄋ丿	户方丶一ㄋ丿
半	半丶丿一一丨	半丶丿一一丨
节	艹卩ㄋ丨丨丨	艹卩ㄋ丨丨丨
土	土一丨一一一	土一丨一一一
投	扌殳丿ㄋㄋ丶	扌殳丿ㄋㄋ丶
某	甘木一丨丿丶	甘木一丨丿丶
案	宀女一丨丿丶	宀女一丨丿丶
黑	黑丨ㄋ丶丿一	黑丨ㄋ丶丿一
维	纟隹丿丨丶一	纟隹丿丨丶一
革	革一丨丨一丨	革一丨丨一丨
划	戋刂丨丨丨丨	戋刂丨丨丨丨
敌	舌文丿一丿丶	舌文丿一丿丶
致	至文丿一丿丶	至文丿一丿丶
陈	耳车丨丿丶丶	耳车丨丿丶丶
律	彳聿ㄋ一一一	彳聿ㄋ一一一
足	口走丨一丿丶	口走丨一丿丶
态	大笔丶ㄋ丶丶	大笔丶ㄋ丶丶
护	扌户丶ㄋ一丿	扌户丶ㄋ一丿
七	七一ㄋㄋㄋㄋ	七一ㄋㄋㄋㄋ
兴	八丿丶丶丶	八丿丶丶丶
派	氵广丿ㄋ丿丶	氵广丿ㄋ丿丶
孩	子亥丶一ㄋ丿	子亥丶一ㄋ丿
验	马亼丶丶丿一	马亼丶丶丿一
责	丰贝丨ㄋ丿丶	丰贝丨ㄋ丿丶
营	萝口丨ㄋ一一	萝口丨ㄋ一一
星	日生丿一一丨	日生丿一一丨
够	勹口丿ㄋ丶丿	勹口丿ㄋ丶丿
章	音十一丨丨丨	音十一丨丨丨
音	音丶一丶丿一	音丶一丶丿一
跟	艮ㄋ一一ㄋ	艮ㄋ一一ㄋ
志	土心丶ㄋ丶丶	土心丶ㄋ丶丶
底	广氏丶丶丶丶	广氏丶丶丶丶
站	立占丨一丨ㄋ	立占丨一丨ㄋ
严	亚笔丿丿丿丿	亚笔丿丿丿丿
巴	巴ㄋ丨一ㄋㄋ	巴ㄋ丨一ㄋㄋ
例	亻歹丨丨丨丨	亻歹丨丨丨丨
防	耳方丶一ㄋ丿	耳方丶一ㄋ丿
族	族矢丿一一丿	族矢丿一一丿
供	亻共一丨丨一	亻共一丨丨一
效	六乂丿一丿丶	六乂丿一丿丶
续	纟十ㄋ丶丶一	纟十ㄋ丶丶一
施	族也ㄋ丨ㄋㄋ	族也ㄋ丨ㄋㄋ
留	留田丨ㄋ一丨	留田丨ㄋ一丨
讲	讠二一一丿丨	讠二一一丿丨
型	开刂一丨一一	开刂一丨一一
料	米冫一丨丨丨	米冫一丨丨丨
终	纟文丶丶丶丶	纟文丶丶丶丶
答	合丿丶一丨	合丿丶一丨
紧	糸ㄋㄋ丶丨	糸ㄋㄋ丶丨
黄	共甲丿丶丶丶	共甲丿丶丶丶
绝	纟鱼ㄋ丨一ㄋ	纟鱼ㄋ丨一ㄋ
奇	大可一丨ㄋ一	大可一丨ㄋ一
察	宀一一丨丿	宀祭一一丨丿
母	母ㄋㄋ丶一丶	母ㄋㄋ丶一丶
京	京丶一丨ㄋ一	京丶一丨ㄋ一
段	段丿丨一一一	段丿丨一一一
依	亻衣丶一丿ㄋ	亻衣丶一丿ㄋ
批	扌比一ㄋ丿ㄋ	扌比一ㄋ丿ㄋ
群	尹口丶丿一一	尹口丶丿一一
项	工页一丿丨ㄋ	工页一丿丨ㄋ
故	古文丿一丿丶	古文丿一丿丶
按	扌宀ㄋ丿一一	扌宀ㄋ丿一一
河	氵可一丨ㄋ一	氵可一丨ㄋ一
米	米丶丿一丨丿	米丶丿一丨丿
围	口韦一一ㄋ丨	口韦一一ㄋ丨
江	氵工一丨一一	氵工一丨一一
织	纟口丿丶丶丶	纟口丿丶丶丶
害	宀丰丨ㄋ一一	宀丰丨ㄋ一一
斗	冫十一丨丨丨	冫十一丨丨丨
双	双ㄋ丶ㄋ丶丶	双ㄋ丶ㄋ丶丶
境	土音丿ㄋㄋㄋ	土音丿ㄋㄋㄋ
客	宀各丿ㄋ丶丨	宀各丿ㄋ丶丨
纪	纟巴ㄋ一ㄋㄋ	纟巴ㄋ一ㄋㄋ
采	爪木一丨丿丶	爪木一丨丿丶
举	八一一丨丨	八一一丨丨
杀	乂木一丨丿丶	乂木一丨丿丶
攻	工文丿一丿丶	工文丿一丿丶
父	父丿丶丿丶丶	父丿丶丿丶丶
苏	艹力丿丶丶丶	艹力丿丶丶丶
密	宀心丿丨ㄋ丨	宀心丿丨ㄋ丨
低	亻氏丶丶丶丶	亻氏丶丶丶丶
朝	月丿ㄋ一一	月丿ㄋ一一
友	石双ㄋ丶丶丶	石双ㄋ丶丶丶
诉	讠丘丶丶丶丶	讠丘丶丶丶丶
止	止丨一丨一一	止丨一丨一一
愿	广白丨丿丶丶	广白丨丿丶丶
细	纟田丨ㄋ一丨	纟田丨ㄋ一丨
千	舌丿一丨丨丨	舌丿一丨丨丨
值	亻直一丨丨ㄋ	亻直一丨丨ㄋ
仍	亻乃ㄋ丿丿丿	亻乃ㄋ丿丿丿
男	田力ㄋ丿丿丿	田力ㄋ丿丿丿
钱	金戋一一ㄋ丿	金戋一一ㄋ丿
破	石皮ㄋ丿丨ㄋ	石皮ㄋ丿丨ㄋ
网	冂乂丿丶丶丶	冂乂丿丶丶丶
热	执水丶丶丶丶	执水丶丶丶丶
助	目力ㄋ丿丿丿	目力ㄋ丿丿丿
倒	亻至丨丨丨丨	亻至丨丨丨丨
育	亡月丨ㄋ一一	亡月丨ㄋ一一
属	尸笔丨ㄋ一丨	尸笔丨ㄋ一丨
坐	从土一丨一一	从土一丨一一
帝	立巾丨ㄋ丨丨	立巾丨ㄋ丨丨
限	耳艮ㄋ一一ㄋ	耳艮ㄋ一一ㄋ
船	舟几丨ㄋ一一	舟几丨ㄋ一一
脸	月亼丶丶丿一	月亼丶丶丿一
职	耳口丿丶丶丶	耳口丿丶丶丶
速	束辶丶ㄋ丶丶	束辶丶ㄋ丶丶
刻	亥刂丨丨丨丨	亥刂丨丨丨丨
乐	留小丨丿丶丶	留小丨丿丶丶
否	不口丨ㄋ一一	不口丨ㄋ一一
刚	冂乂丨丨丨丨	冂乂丨丨丨丨
威	戊笔ㄋ丿一一	戊笔ㄋ丿一一
毛	毛丿一一ㄋㄋ	毛丿一一ㄋㄋ
状	北犬一丿丶丶	北犬一丿丶丶
率	亠幺丶一丿丶	亠幺丶一丿丶
甚	其乙ㄋㄋㄋㄋ	其乙ㄋㄋㄋㄋ
独	犬虫丨ㄋ一丨	犬虫丨ㄋ一丨
球	王求一丨丶一	王求一丨丶一
般	舟殳丿ㄋㄋ丶	舟殳丿ㄋㄋ丶
普	䒑业丨ㄋ一一	首业丨ㄋ一一
怕	忄白丿丨ㄋ一	忄白丿丨ㄋ一
弹	弓单丶丿丨ㄋ	弓单丶丿丨ㄋ
校	木六丿丶丶丶	木六丿丶丶丶
苦	艹古一丨丨ㄋ	艹古一丨丨ㄋ
创	人巴丨丨丨丨	人巴丨丨丨丨
假	亻叚ㄋ一丨一	亻叚ㄋ一丨一
久	久丿ㄋ丶丶丶	久丿ㄋ丶丶丶
错	金共丨ㄋ一一	金共丨ㄋ一一
承	了三ㄋ丿丶丶	了三ㄋ丿丶丶
印	留笔ㄋ丨丨丨	留笔ㄋ丨丨丨
晚	日象丿ㄋㄋㄋ	日象丿ㄋㄋㄋ
兰	䒑二一一一一	首二一一一一
试	讠戋一丨一一	讠戋一丨一一
股	月殳丿ㄋㄋ丶	月殳丿ㄋㄋ丶
拿	合手丿一一丨	合手丿一一丨
脑	月㐫丶一丿丶	月离丶一丿丶
预	矛页一丿丨ㄋ	矛页一丿丨ㄋ
谁	讠隹丿丨丶一	讠隹丿丨丶一
益	䒑八丨ㄋ丨丨	首八丨ㄋ丨丨
阳	耳日丨ㄋ一一	耳日丨ㄋ一一
若	艹石丨ㄋ一一	艹石丨ㄋ一一
哪	口刀ㄋ丨丨丨	口刀ㄋ丨丨丨
微	几丿ㄋㄋㄋ	几丿ㄋㄋㄋ
尼	尸七丿ㄋㄋㄋ	尸七丿ㄋㄋㄋ
继	纟米ㄋㄋㄋㄋ	纟米ㄋㄋㄋㄋ
送	䒑大丶ㄋ丶丶	首大丶ㄋ丶丶
急	刍心丶ㄋ丶丶	刍心丶ㄋ丶丶
血	笔四丨ㄋ丨丨	笔四丨ㄋ丨丨
惊	忄京丶一丨ㄋ	忄京丶一丨ㄋ
伤	亻ㄋ丿丿丿	亻ㄋ丿丿丿
素	丰糸ㄋㄋ丶丨	丰糸ㄋㄋ丶丨
药	艹纟丿ㄋ丶丶	艹纟丿ㄋ丶丶
适	舌辶丶ㄋ丶丶	舌辶丶ㄋ丶丶
波	氵皮ㄋ丿丨ㄋ	氵皮ㄋ丿丨ㄋ
夜	亠亻丿ㄋ丶丶	亠亻丿ㄋ丶丶
省	少目丨ㄋ一一	少目丨ㄋ一一
初	衤刀ㄋ丿丿丿	衤刀ㄋ丿丿丿
喜	壴口丨ㄋ一一	壴口丨ㄋ一一
卫	卩笔一一一一	卩笔一一一一
源	氵广丿丨ㄋ一	氵广丿丨ㄋ一
食	食丿丶丶ㄋ一	食丿丶丶ㄋ一
险	耳亼丶丶丿一	耳亼丶丶丿一
待	彳土一丨丶丶	彳土一丨丶丶
述	木笔丶ㄋ丶丶	木笔丶ㄋ丶丶
陆	耳土ㄋ丨丨丨	耳土ㄋ丨丨丨
习	羽ㄋ丶一一一	羽ㄋ丶一一一
置	四直一丨丨ㄋ	四直一丨丨ㄋ
居	尸古一丨丨ㄋ	尸古一丨丨ㄋ
劳	萝力ㄋ丿丿丿	萝力ㄋ丿丿丿
财	贝㇉一丨丿丿	贝Z一丨丿丿
环	王不一丿丨丶	王不一丿丨丶
排	扌非丨一一一	扌非丨一一一
福	衤鬲丨ㄋ一丨	衤鬲丨ㄋ一丨
纳	纟内丨ㄋ丿丶	纟内丨ㄋ丿丶
欢	双欠丿ㄋ丿丶	双欠丿ㄋ丿丶
雷	田丨ㄋ一丨	田丨ㄋ一丨
警	芍口丿一丿丶	芍口丿一丿丶
获	艹犬一丿丶丶	艹犬一丿丶丶
模	木莫一丨丨丨	木莫一丨丨丨
充	亡儿丿ㄋㄋㄋ	亡儿丿ㄋㄋㄋ
负	鱼贝丨ㄋ丿丶	鱼贝丨ㄋ丿丶
云	云一一ㄋ丶丶	云一一ㄋ丶丶
停	亻一丨丨丨	亻一丨丨丨
木	木一丨丿丶丶	木一丨丿丶丶
游	氵族ㄋ丨一一	氵族ㄋ丨一一
龙	龙一丿ㄋ丿丶	龙一丿ㄋ丿丶
树	木双一丨丶丶	木双一丨丶丶
疑	七矢ㄋ丶ㄋ丨	七矢ㄋ丶ㄋ丨
层	尸云一一ㄋ丶	尸云一一ㄋ丶
冷	冫令丿丶丶ㄋ	冫令丿丶丶ㄋ
洲	氵川丶丶丶丶	氵川丶丶丶丶
冲	冫中丨ㄋ一丨	冫中丨ㄋ一丨
射	身寸一丨丶丶	身寸一丨丶丶
略	田各丿ㄋ丶丨	田各丿ㄋ丶丨
竟	音儿丿ㄋㄋㄋ	音儿丿ㄋㄋㄋ
范	落巴ㄋㄋㄋㄋ	落巴ㄋㄋㄋㄋ
句	勹口丨ㄋ一一	勹口丨ㄋ一一
室	宀至一ㄋ丶一	宀至一ㄋ丶一
异	巴开一丿丨丨	巴开一丿丨丨
激	氵白丶一ㄋ丿	氵白丶一ㄋ丿
汉	氵双ㄋ丶丶丶	氵双ㄋ丶丶丶
村	木寸一丨丶丶	木寸一丨丶丶
哈	口合丿丶一丨	口合丿丶一丨
演	氵宀一丨ㄋ一	氵宀一丨ㄋ一
策	朿一丨ㄋ丨	朿一丨ㄋ丨
简	门丨ㄋ一一	门丨ㄋ一一
卡	上卜丨丶丶丶	上卜丨丶丶丶
罪	四非丨一一一	四非丨一一一
判	半刂丨丨丨丨	半刂丨丨丨丨
担	扌旦丨ㄋ一一	扌旦丨ㄋ一一
州	川水丶丶丶丶	川水丶丶丶丶
静	青争丿ㄋㄋ一	青争丿ㄋㄋ一
退	艮辶丶ㄋ丶丶	艮辶丶ㄋ丶丶
既	旡一ㄋ丿ㄋ	旡一ㄋ丿ㄋ
衣	衣丶一丿ㄋ丿	衣丶一丿ㄋ丿
您	亻尔丶ㄋ丶丶	亻尔丶ㄋ丶丶
宗	宀示一一丨丿	宀示一一丨丿
积	禾口丿丶丶丶	禾口丿丶丶丶
余	亼木一丨丿丶	亼木一丨丿丶
痛	疒甬ㄋ丶丨ㄋ	疒甬ㄋ丶丨ㄋ
检	木亼丶丶丿一	木亼丶丶丿一
差	羊工一丨一一	羊工一丨一一
富	宀鬲丨ㄋ一丨	宀鬲丨ㄋ一丨
灵	尹火丶丿丿丶	尹火丶丿丿丶
协	十力丿丶丶丶	十力丿丶丶丶
角	角丿ㄋ丿ㄋ一	角丿ㄋ丿ㄋ一
占	占丨一丨ㄋ一	占丨一丨ㄋ一
配	西巴ㄋ一ㄋㄋ	西巴ㄋ一ㄋㄋ
征	彳正一丨一丨	彳正一丨一丨
修	亻文丿丿丿丿	亻文丿丿丿丿
皮	皮ㄋ丿丨ㄋ丶	皮ㄋ丿丨ㄋ丶
挥	扌冖一ㄋ一丨	扌冖一ㄋ一丨
胜	月生丿一一丨	月生丿一一丨
降	耳文一ㄋ丨丨	耳文一ㄋ丨丨
阶	耳人丿丨丨丨	耳人丿丨丨丨
审	宀日丨丨丨丨	宀日丨丨丨丨
沉	氵冖丿ㄋㄋㄋ	氵冖丿ㄋㄋㄋ
坚	土一丨一一	土一丨一一
善	羊䒑丨ㄋ一一	羊首丨ㄋ一一
妈	女马ㄋㄋ一一	女马ㄋㄋ一一
刘	文刂丨丨丨丨	文刂丨丨丨丨
读	讠十ㄋ丶丶一	讠十ㄋ丶丶一
啊	口耳一丨ㄋ一	口耳一丨ㄋ一
超	走刀丨ㄋ一一	走刀丨ㄋ一一
免	象儿丿ㄋㄋㄋ	象儿丿ㄋㄋㄋ
压	广土丶丶丶丶	广土丶丶丶丶
银	金艮ㄋ一一ㄋ	金艮ㄋ一一ㄋ
买	㇉冫一丿丶丶	Z冫一丿丶丶
皇	白王一一丨一	白王一一丨一
养	羊笔丿丨丨丨	羊笔丿丨丨丨
伊	亻尹ㄋ一一丿	亻尹ㄋ一一丿
怀	忄不一丿丨丶	忄不一丿丨丶
执	执一丨一丿ㄋ	执一丨一丿ㄋ
副	鬲田丨丨丨丨	鬲田丨丨丨丨
乱	舌乙ㄋㄋㄋㄋ	舌乙ㄋㄋㄋㄋ
抗	扌亠丿ㄋㄋㄋ	扌亠丿ㄋㄋㄋ
犯	犬巴ㄋㄋㄋㄋ	犬巴ㄋㄋㄋㄋ
追	笔吅丶ㄋ丶丶	笔吅丶ㄋ丶丶
帮	丰耳丨ㄋ丨丨	丰耳丨ㄋ丨丨
宣	宀笔丨ㄋ一一	宀笔丨ㄋ一一
佛	亻弓丿丨丨丨	亻弓丿丨丨丨
岁	山歹丿ㄋ丶丶	山歹丿ㄋ丶丶
航	舟亠丿ㄋㄋㄋ	舟亠丿ㄋㄋㄋ
优	亻尢丶丶丶丶	亻尢丶丶丶丶
怪	忄双一丨一一	忄双一丨一一
香	禾日丨ㄋ一一	禾日丨ㄋ一一
著	艹者一丨一丿	艹者一丨一丿
田	田丨ㄋ一丨一	田丨ㄋ一丨一
铁	金笔一一丿丶	金笔一一丿丶
控	扌穴一丨一一	扌穴一丨一一
税	禾𠮦丿ㄋㄋㄋ	禾兑丿ㄋㄋㄋ
左	石工一丨一一	石工一丨一一
右	石口丨ㄋ一一	石口丨ㄋ一一
份	亻分丿丶ㄋ丿	亻分丿丶ㄋ丿
穿	穴牙一ㄋ丨丿	穴牙一ㄋ丨丿
艺	艹乙ㄋㄋㄋㄋ	艹乙ㄋㄋㄋㄋ
背	北月丨ㄋ一一	北月丨ㄋ一一
阵	耳车一ㄋ一丨	耳车一ㄋ一丨
草	艹日一丨丨丨	艹日一丨丨丨
脚	月去ㄋ丨丨丨	月去ㄋ丨丨丨
概	木一ㄋ丿ㄋ	木一ㄋ丿ㄋ
恶	亚心丶ㄋ丶丶	亚心丶ㄋ丶丶
块	土匚丿丶丶丶	土匚丿丶丶丶
顿	屯页一丿丨ㄋ	屯页一丿丨ㄋ
敢	㇉耳丿一丿丶	Z耳丿一丿丶
守	宀寸一丨丶丶	宀寸一丨丶丶
酒	氵西一丨ㄋ丿	氵西一丨ㄋ丿
岛	鸟山丨ㄋ丨丨	鸟山丨ㄋ丨丨
托	扌笔一ㄋㄋㄋ	扌笔一ㄋㄋㄋ
央	冂大一丿丶丶	冂大一丿丶丶
户	户丶ㄋ一丿丿	户丶ㄋ一丿丿
烈	歹刂丶丶丶丶	歹刂丶丶丶丶
洋	氵羊丶丿一一	氵羊丶丿一一
哥	可可一丨ㄋ一	可可一丨ㄋ一
索	糸ㄋㄋ丶丨	糸ㄋㄋ丶丨
胡	古月丿ㄋ一一	古月丿ㄋ一一
款	土示丿ㄋ丿丶	土示丿ㄋ丿丶
靠	告非丨一一一	告非丨一一一
评	讠平一丶丿一	讠平一丶丿一
版	片广ㄋ丶丶丶	片广ㄋ丶丶丶
宝	宀王丶丶丶丶	宀王丶丶丶丶
座	广从一丨一一	广从一丨一一
释	釆双一一丨丨	釆双一一丨丨
景	日京丶一丨ㄋ	日京丶一丨ㄋ
顾	广巴一丿丿丿	广巴一丿丿丿
弟	弓丶丿ㄋ一ㄋ	弓丶丿ㄋ一ㄋ
登	豆一丨ㄋ一	祭豆一丨ㄋ一
货	化贝丨ㄋ丿丶	化贝丨ㄋ丿丶
互	笔彑ㄋㄋ一一	笔彑ㄋㄋ一一
付	亻寸一丨丶丶	亻寸一丨丶丶
伯	亻白丿丨ㄋ一	亻白丿丨ㄋ一
慢	忄日丨ㄋ丨丨	忄日丨ㄋ丨丨
欧	区欠丿ㄋ丿丶	区欠丿ㄋ丿丶
换	扌鱼丨ㄋ一丿	扌鱼丨ㄋ一丿
闻	门耳一丨丨一	门耳一丨丨一
危	厃巴ㄋㄋㄋㄋ	厃巴ㄋㄋㄋㄋ
忙	忄亡丶一ㄋㄋ	忄亡丶一ㄋㄋ
核	木亥丶一ㄋ丿	木亥丶一ㄋ丿
暗	日音丶一丶丿	日音丶一丶丿
姐	女目丨ㄋ一一	女目丨ㄋ一一
介	人刂丿丨丨丨	人刂丿丨丨丨
坏	土不一丿丨丶	土不一丿丨丶
讨	讠寸一丨丶丶	讠寸一丨丶丶
丽	丽一丨ㄋ丶丨	丽一丨ㄋ丶丨
良	笔艮ㄋ一一ㄋ	笔艮ㄋ一一ㄋ
序	广矛ㄋ丶ㄋ丨	广矛ㄋ丶ㄋ丨
升	笔开一丿丨丨	笔开一丿丨丨
监	四丨ㄋ丨丨	四丨ㄋ丨丨
临	刂丶丨ㄋ丨	刂丶丨ㄋ丨
亮	几丿ㄋㄋㄋ	几丿ㄋㄋㄋ
露	丿ㄋ丶丨	丿ㄋ丶丨
永	笔㇉ㄋ丿丶丶	笔Zㄋ丿丶丶
呼	口乎丿丶丿一	口乎丿丶丿一
味	口未丨丿丶丶	口未丨丿丶丶
野	田矛ㄋ丶ㄋ丨	田矛ㄋ丶ㄋ丨
架	加木一丨丿丶	加木一丨丿丶
域	土戋丨ㄋ一一	土戋丨ㄋ一一
沙	氵少丨丿丶丿	氵少丨丿丶丿
掉	扌卜丨ㄋ一一	扌卜丨ㄋ一一
括	扌舌丿一丨丨	扌舌丿一丨丨
舰	舟见丨ㄋ丿ㄋ	舟见丨ㄋ丿ㄋ
鱼	鱼丿ㄋ丨ㄋ一	鱼丿ㄋ丨ㄋ一
杂	九木一丨丿丶	九木一丨丿丶
误	讠口一一丿丶	讠口一一丿丶
湾	氵亦ㄋ一ㄋㄋ	氵亦ㄋ一ㄋㄋ
吉	吉一丨一丨ㄋ	吉一丨一丨ㄋ
减	冫戊一丨ㄋ一	冫戊一丨ㄋ一
编	纟户丨ㄋ一丨	纟户丨ㄋ一丨
楚	林走ㄋ丨一丿	林走ㄋ丨一丿
肯	止月丨ㄋ一一	止月丨ㄋ一一
测	氵贝丨丨丨丨	氵贝丨丨丨丨
败	贝文丿一丿丶	贝文丿一丿丶
屋	尸至一ㄋ丶一	尸至一ㄋ丶一
跑	勹ㄋ一ㄋㄋ	勹ㄋ一ㄋㄋ
梦	林歹丿ㄋ丶丶	林歹丿ㄋ丶丶
散	共月丿一丿丶	共月丿一丿丶
温	氵日丨ㄋ丨丨	氵日丨ㄋ丨丨
困	口木一丨丿丶	口木一丨丿丶
剑	亼丨丨丨丨	亼丨丨丨丨
渐	氵车丿丿一丨	氵车丿丿一丨
封	圭寸一丨丶丶	圭寸一丨丶丶
救	求文丿一丿丶	求文丿一丿丶
贵	贝丨ㄋ丿丶	贝丨ㄋ丿丶
枪	木人ㄋㄋㄋㄋ	木人ㄋㄋㄋㄋ
缺	缶匚丿丶丶丶	缶匚丿丶丶丶
楼	木米ㄋ丿一一	木米ㄋ丿一一
县	目厶ㄋ丶丶丶	目厶ㄋ丶丶丶
尚	冂丨ㄋ一一	冂丨ㄋ一一
毫	毛丿一一ㄋ	毛丿一一ㄋ
移	禾歹丿ㄋ丶丶	禾歹丿ㄋ丶丶
娘	女笔ㄋ一一ㄋ	女笔ㄋ一一ㄋ
朋	月月丿ㄋ一一	月月丿ㄋ一一
画	笔田ㄋ丨丨丨	笔田ㄋ丨丨丨
班	王刂一一丨一	王刂一一丨一
智	矢口丨ㄋ一一	矢口丨ㄋ一一
亦	亦丶一丿丨丿	亦丶一丿丨丿
耳	耳一丨丨一一	耳一丨丨一一
恩	因心丶ㄋ丶丶	因心丶ㄋ丶丶
短	矢豆一丨ㄋ一	矢豆一丨ㄋ一
掌	手丿一一丨	手丿一一丨
恐	工几丶丶ㄋ丶	工几丶丶ㄋ丶
遗	贝丶ㄋ丶丶	贝丶ㄋ丶丶
固	口古一丨丨ㄋ	口古一丨丨ㄋ
席	度巾丨ㄋ丨丨	度巾丨ㄋ丨丨
松	木公丿丶ㄋ丶	木公丿丶ㄋ丶
秘	禾心丿丿丿丿	禾心丿丿丿丿
谢	讠身一丨丶丶	讠身一丨丶丶
鲁	鱼日丨ㄋ一一	鱼日丨ㄋ一一
遇	日内丶ㄋ丶丶	日内丶ㄋ丶丶
康	广尹丨丶一丿	广尹丨丶一丿
虑	虍心丶ㄋ丶丶	虍心丶ㄋ丶丶
幸	土羊丶丿一一	土羊丶丿一一
均	土勹丶一一一	土勹丶一一一
销	金丨ㄋ一一	金丨ㄋ一一
钟	金中丨ㄋ一丨	金中丨ㄋ一丨
诗	讠土一丨丶丶	讠土一丨丶丶
藏	艹戊ㄋㄋㄋㄋ	艹戊ㄋㄋㄋㄋ
赶	走舌一一丨丨	走舌一一丨丨
剧	尸古丨丨丨丨	尸古丨丨丨丨
票	西示一一丨丿	西示一一丨丿
损	扌口丨ㄋ丿丶	扌口丨ㄋ丿丶
忽	勿心丶ㄋ丶丶	勿心丶ㄋ丶丶
巨	匚匚ㄋ一一一	匚匚ㄋ一一一
炮	火勹ㄋ一ㄋㄋ	火勹ㄋ一ㄋㄋ
旧	笔日丨ㄋ一一	笔日丨ㄋ一一
端	立山一丿丨ㄋ	立山一丿丨ㄋ
探	扌冖丿丶一丨	扌冖丿丶一丨
湖	氵古丿ㄋ一一	氵古丿ㄋ一一
录	尹水丨ㄋ丿丶	尹水丨ㄋ丿丶
叶	口十一丨丨丨	口十一丨丨丨
春	日丨ㄋ一一	日丨ㄋ一一
乡	幺笔丿丿丿丿	幺笔丿丿丿丿
附	耳亻一丨丶丶	耳亻一丨丶丶
吸	口及丿ㄋ丶丶	口及丿ㄋ丶丶
予	矛ㄋ丶ㄋ丨丨	矛ㄋ丶ㄋ丨丨
礼	衤乙ㄋㄋㄋㄋ	衤乙ㄋㄋㄋㄋ
港	氵共ㄋ一ㄋㄋ	氵共ㄋ一ㄋㄋ
雨	雨一丨ㄋ丨丶	雨一丨ㄋ丨丶
呀	口牙一ㄋ丨丿	口牙一ㄋ丨丿
板	木广ㄋ丶丶丶	木广ㄋ丶丶丶
庭	广王ㄋ丶丶丶	广王ㄋ丶丶丶
妇	女尹ㄋ一一一	女尹ㄋ一一一
归	刂尹ㄋ一一一	刂尹ㄋ一一一
睛	目青一一丨一	目青一一丨一
饭	食广ㄋ丶丶丶	食广ㄋ丶丶丶
额	宀各一丿丨ㄋ	宀各一丿丨ㄋ
含	令口丨ㄋ一一	令口丨ㄋ一一
顺	川页一丿丨ㄋ	川页一丿丨ㄋ
输	车亼丨ㄋ一一	车亼丨ㄋ一一
摇	扌爪丿一一丨	扌爪丿一一丨
招	扌刀丨ㄋ一一	扌刀丨ㄋ一一
婚	女氏丨ㄋ一一	女氏丨ㄋ一一
脱	月𠮦丿ㄋㄋㄋ	月兑丿ㄋㄋㄋ
补	衤卜丨丶丶丶	衤卜丨丶丶丶
谓	讠田丨ㄋ一一	讠田丨ㄋ一一
督	上小ㄋ丶丨ㄋ	上小ㄋ丶丨ㄋ
毒	丰母ㄋㄋ丶一	丰母ㄋㄋ丶一
油	氵甲丨ㄋ一丨	氵甲丨ㄋ一丨
疗	疒了ㄋ丨丨丨	疒了ㄋ丨丨丨
旅	族衣丿ㄋ丿丶	族衣丿ㄋ丿丶
泽	氵双一一丨丨	氵双一一丨丨
材	木㇉一丨丿丿	木Z一丨丿丿
灭	笔火丶丿丿丶	笔火丶丿丿丶
逐	豕辶丶ㄋ丶丶	豕辶丶ㄋ丶丶
莫	莫一丨丨丨ㄋ	莫一丨丨丨ㄋ
笔	毛丿一一ㄋ	毛丿一一ㄋ
亡	亡丶一ㄋㄋㄋ	亡丶一ㄋㄋㄋ
鲜	鱼羊丶丿一一	鱼羊丶丿一一
词	讠㇉一丨ㄋ一	讠Z一丨ㄋ一
圣	双土一丨一一	双土一丨一一
择	扌双一一丨丨	扌双一一丨丨
寻	尹寸一丨丶丶	尹寸一丨丶丶
厂	广一丿丿丿丿	广一丿丿丿丿
睡	目垂丿一丨一	目垂丿一丨一
博	十甫一丨丶丶	十甫一丨丶丶
勒	革力ㄋ丿丿丿	革力ㄋ丿丿丿
烟	火因丨ㄋ一丿	火因丨ㄋ一丿
授	扌ㄋ丶丶丶	扌ㄋ丶丶丶
诺	讠艹一丿丨ㄋ	讠艹一丿丨ㄋ
伦	亻仑丿丶丿ㄋ	亻仑丿丶丿ㄋ
岸	山广一一丨丨	山广一一丨丨
奥	米一丿丶丶	米一丿丶丶
唐	广聿丨ㄋ一一	广聿丨ㄋ一一
卖	十㇉丶丶一丿	十Z丶丶一丿
俄	亻我丿一丨一	亻我丿一丨一
炸	火乍丿一丨一	火乍丿一丨一
载	车一ㄋ一丨	车一ㄋ一丨
洛	氵各丿ㄋ丶丨	氵各丿ㄋ丶丨
健	亻聿ㄋ丶丶丶	亻聿ㄋ丶丶丶
堂	土一丨一一	土一丨一一
旁	立方丶一ㄋ丿	立方丶一ㄋ丿
宫	宀口丨ㄋ一一	宀口丨ㄋ一一
喝	口日丿ㄋ丿丶	口日丿ㄋ丿丶
借	亻共丨ㄋ一一	亻共丨ㄋ一一
君	尹口丨ㄋ一一	尹口丨ㄋ一一
禁	林示一一丨丿	林示一一丨丿
阴	耳月丿ㄋ一一	耳月丿ㄋ一一
园	口元一一丿ㄋ	口元一一丿ㄋ
谋	讠甘一丨丿丶	讠甘一丨丿丶
宋	宀木一丨丿丶	宀木一丨丿丶
避	辟辶丶ㄋ丶丶	辟辶丶ㄋ丶丶
抓	扌爪丿丿丨丶	扌爪丿丿丨丶
荣	萝木一丨丿丶	萝木一丨丿丶
姑	女古一丨丨ㄋ	女古一丨丨ㄋ
孙	子小丨丿丶丶	子小丨丿丶丶
逃	儿水丶ㄋ丶丶	儿水丶ㄋ丶丶
牙	牙一ㄋ丨丿丿	牙一ㄋ丨丿丿
束	束一丨ㄋ一丨	束一丨ㄋ一丨
跳	儿丶一丿丶	儿丶一丿丶
顶	于页一丿丨ㄋ	于页一丿丨ㄋ
玉	王笔丶丶丶丶	王笔丶丶丶丶
镇	金直丿丶丶丶	金直丿丶丶丶
雪	尹ㄋ一一一	尹ㄋ一一一
午	十一丨丨丨	十一丨丨丨
练	纟车ㄋ丿丶丶	纟车ㄋ丿丶丶
爷	父卩ㄋ丨丨丨	父卩ㄋ丨丨丨
迫	白辶丶ㄋ丶丶	白辶丶ㄋ丶丶
篇	户丨ㄋ一丨	户丨ㄋ一丨
肉	内人丿丶丶丶	内人丿丶丶丶
嘴	口此丿ㄋ丿ㄋ	口此丿ㄋ丿ㄋ
馆	食宀丨ㄋ一ㄋ	食宀丨ㄋ一ㄋ
遍	户丶ㄋ丶丶	户丶ㄋ丶丶
凡	几笔丶丶丶丶	几笔丶丶丶丶
础	石山ㄋ丨丨丨	石山ㄋ丨丨丨
洞	氵冂一丨ㄋ一	氵冂一丨ㄋ一
卷	巴ㄋㄋㄋㄋ	巴ㄋㄋㄋㄋ
坦	土旦丨ㄋ一一	土旦丨ㄋ一一
牛	牛丿一一丨丨	牛丿一一丨丨
宁	宀于一丨丨丨	宀于一丨丨丨
纸	纟氏丿ㄋ一ㄋ	纟氏丿ㄋ一ㄋ
诸	讠者一丨一丿	讠者一丨一丿
训	讠川丿丨丨丨	讠川丿丨丨丨
私	禾厶ㄋ丶丶丶	禾厶ㄋ丶丶丶
庄	广土一丨一一	广土一丨一一
祖	衤目丨ㄋ一一	衤目丨ㄋ一一
丝	幺幺一一一一	幺幺一一一一
翻	釆田ㄋ丶一ㄋ	釆田ㄋ丶一ㄋ
暴	日共丨丶一丿	日共丨丶一丿
森	木林一丨丿丶	木林一丨丿丶
塔	土艹丿丶一丨	土艹丿丶一丨
默	黑犬一丿丶丶	黑犬一丿丶丶
握	扌尸一ㄋ丶一	扌尸一ㄋ丶一
戏	双戋一ㄋ丿丶	双戋一ㄋ丿丶
隐	耳刍丶ㄋ丶丶	耳刍丶ㄋ丶丶
熟	子丿ㄋ丶丶	子丿ㄋ丶丶
骨	骨丨ㄋㄋ丶ㄋ	骨丨ㄋㄋ丶ㄋ
访	讠方丶一ㄋ丿	讠方丶一ㄋ丿
弱	弓冫ㄋ一ㄋ丶	弓冫ㄋ一ㄋ丶
蒙	萝笔一丿ㄋ丿	萝笔一丿ㄋ丿
歌	可可丿ㄋ丿丶	可可丿ㄋ丿丶
店	广占丨一丨ㄋ	广占丨一丨ㄋ
鬼	鬼丿丨ㄋ一一	鬼丿丨ㄋ一一
软	车欠丿ㄋ丿丶	车欠丿ㄋ丿丶
典	甲八丿丶丶丶	甲八丿丶丶丶
欲	八人丨ㄋ一丿	八人丨ㄋ一丿
萨	艹耳丶一丶丿	艹耳丶一丶丿
伙	亻火丶丿丿丶	亻火丶丿丿丶
遭	笔甲丨ㄋ一一	笔甲丨ㄋ一一
盘	舟四丨ㄋ丨丨	舟四丨ㄋ丨丨
爸	父巴ㄋ丨一ㄋ	父巴ㄋ丨一ㄋ
扩	扌广丶一丿丿	扌广丶一丿丿
盖	羊四丨ㄋ丨丨	羊四丨ㄋ丨丨
弄	王开一丿丨丨	王开一丿丨丨
雄	石厶丿丨丶一	石厶丿丨丶一
稳	禾刍丶ㄋ丶丶	禾刍丶ㄋ丶丶
忘	亡心丶ㄋ丶丶	亡心丶ㄋ丶丶
亿	亻乙ㄋㄋㄋㄋ	亻乙ㄋㄋㄋㄋ
刺	朿刂丨丨丨丨	朿刂丨丨丨丨
拥	扌甬丿ㄋ一一	扌甬丿ㄋ一一
徒	彳走一丨一丨	彳走一丨一丨
姆	女母ㄋㄋ丶一	女母ㄋㄋ丶一
杨	木㇉丿丿丿丿	木Z丿丿丿丿
齐	文刂丿丨丨丨	文刂丿丨丨丨
赛	寒贝丨ㄋ丿丶	寒贝丨ㄋ丿丶
趣	走耳ㄋ丶丶丶	走耳ㄋ丶丶丶
曲	甲丨ㄋ一丨丨	甲丨ㄋ一丨丨
刀	刀ㄋ丿丿丿丿	刀ㄋ丿丿丿丿
床	广木一丨丿丶	广木一丨丿丶
迎	留卩丶ㄋ丶丶	留卩丶ㄋ丶丶
冰	冫水丨ㄋ丿丶	冫水丨ㄋ丿丶
虚	虍业丨丨丶丿	虍业丨丨丶丿
玩	王元一一丿ㄋ	王元一一丿ㄋ
析	木丘丿丿一丨	木丘丿丿一丨
窗	穴丿ㄋ丶一	穴丿ㄋ丶一
醒	西日丿一一丨	西日丿一一丨
妻	笔聿ㄋ丿一一	笔聿ㄋ丿一一
透	禾乃丶ㄋ丶丶	禾乃丶ㄋ丶丶
购	贝勹ㄋ丶丶丶	贝勹ㄋ丶丶丶
替	夫夫丨ㄋ一一	夫夫丨ㄋ一一
塞	寒土一丨一一	寒土一丨一一
努	奴力ㄋ丿丿丿	奴力ㄋ丿丿丿
休	亻木一丨丿丶	亻木一丨丿丶
虎	虍几丿ㄋㄋㄋ	虍几丿ㄋㄋㄋ
扬	扌㇉丿丿丿丿	扌Z丿丿丿丿
途	亼木丶ㄋ丶丶	亼木丶ㄋ丶丶
侵	亻尹丶ㄋㄋ丶	亻尹丶ㄋㄋ丶
刑	开刂丨丨丨丨	开刂丨丨丨丨
绿	纟尹丨ㄋ丿丶	纟尹丨ㄋ丿丶
兄	口儿丿ㄋㄋㄋ	口儿丿ㄋㄋㄋ
迅	乙十丶ㄋ丶丶	乙十丶ㄋ丶丶
套	大长一丨一一	大长一丨一一
贸	留贝丨ㄋ丿丶	留贝丨ㄋ丿丶
毕	比十一丨丨丨	比十一丨丨丨
唯	口隹丿丨丶一	口隹丿丨丶一
谷	八人丨ㄋ一一	八人丨ㄋ一一
轮	车仑丿丶丿ㄋ	车仑丿丶丿ㄋ
库	广车一ㄋ一丨	广车一ㄋ一丨
迹	亦辶丶ㄋ丶丶	亦辶丶ㄋ丶丶
尤	尢笔丶丶丶丶	尢笔丶丶丶丶
竞	立口丿ㄋㄋㄋ	立口丿ㄋㄋㄋ
街	彳圭一一丨丨	彳圭一一丨丨
促	亻口丨一丿丶	亻口丨一丿丶
延	笔止ㄋ丶丶丶	笔止ㄋ丶丶丶
震	辰一丿一一	辰一丿一一
弃	亡开一丿丨丨	亡开一丿丨丨
甲	甲丨ㄋ一一丨	甲丨ㄋ一一丨
伟	亻韦一一ㄋ丨	亻韦一一ㄋ丨
麻	麻丶一丿一丨	麻丶一丿一丨
川	川丿丨丨丨丨	川丿丨丨丨丨
申	日笔丨丨丨丨	日笔丨丨丨丨
缓	纟爪一一丿ㄋ	纟爪一一丿ㄋ
潜	氵夫一一丿丶	氵夫一一丿丶
闪	门人丿丶丶丶	门人丿丶丶丶
售	隹口丨ㄋ一一	隹口丨ㄋ一一
灯	火于一丨丨丨	火于一丨丨丨
针	金十一丨丨丨	金十一丨丨丨
哲	折口丨ㄋ一一	折口丨ㄋ一一
络	纟各丿ㄋ丶丨	纟各丿ㄋ丶丨
抵	扌氏丶丶丶丶	扌氏丶丶丶丶
朱	笔未丨丿丶丶	笔未丨丿丶丶
埃	土厶丿一一丿	土厶丿一一丿
抱	扌勹ㄋ一ㄋㄋ	扌勹ㄋ一ㄋㄋ
鼓	壴十ㄋ丶丶丶	壴十ㄋ丶丶丶
植	木直一丨丨ㄋ	木直一丨丨ㄋ
纯	纟屯一ㄋ丨ㄋ	纟屯一ㄋ丨ㄋ
夏	石目丿ㄋ丶丶	石目丿ㄋ丶丶
忍	刀笔丶ㄋ丶丶	刀笔丶ㄋ丶丶
页	页一丿丨ㄋ丿	页一丿丨ㄋ丿
杰	木水丶丶丶丶	木水丶丶丶丶
筑	工丿ㄋ丶丶	工丿ㄋ丶丶
折	折一丨一丿丿	折一丨一丿丿
郑	䒑大ㄋ丨丨丨	首大ㄋ丨丨丨
贝	贝丨ㄋ丿丶丶	贝丨ㄋ丿丶丶
尊	酋寸一丨丶丶	酋寸一丨丶丶
吴	口天一一丿丶	口天一一丿丶
秀	禾乃ㄋ丿丿丿	禾乃ㄋ丿丿丿
混	氵日一ㄋ丿ㄋ	氵日一ㄋ丿ㄋ
臣	臣一丨ㄋ一丨	臣一丨ㄋ一丨
雅	牙隹丿丨丶一	牙隹丿丨丶一
振	扌辰一丿一一	扌辰一丿一一
染	氵九一丨丿丶	氵九一丨丿丶
盛	戊㇉丨ㄋ丨丨	戊Z丨ㄋ丨丨
怒	奴心丶ㄋ丶丶	奴心丶ㄋ丶丶
舞	艹丿ㄋ丶一	艹丿ㄋ丶一
圆	口口丨ㄋ丿丶	口口丨ㄋ丿丶
搞	扌丨ㄋ一一	扌丨ㄋ一一
狂	犬王一一丨一	犬王一一丨一
措	扌共丨ㄋ一一	扌共丨ㄋ一一
姓	女生丿一一丨	女生丿一一丨
秋	禾火丶丿丿丶	禾火丶丿丿丶
残	歹戋一一ㄋ丿	歹戋一一ㄋ丿
培	土立丨ㄋ一一	土立丨ㄋ一一
迷	米辶丶ㄋ丶丶	米辶丶ㄋ丶丶
诚	讠戊ㄋㄋㄋㄋ	讠戊ㄋㄋㄋㄋ
宽	宀艹丨ㄋ丿ㄋ	宀艹丨ㄋ丿ㄋ
宇	宀于一一丨丨	宀于一一丨丨
猛	犬子丨ㄋ丨丨	犬子丨ㄋ丨丨
摆	扌四一丨一ㄋ	扌四一丨一ㄋ
梅	木ㄋㄋ丶一	木ㄋㄋ丶一
毁	鼠工丿ㄋㄋ丶	鼠工丿ㄋㄋ丶
伸	亻日丨丨丨丨	亻日丨丨丨丨
摩	麻手丿一一丨	麻手丿一一丨
盟	日月丨ㄋ丨丨	日月丨ㄋ丨丨
末	笔木一丨丿丶	笔木一丨丿丶
乃	乃ㄋ丿丿丿丿	乃ㄋ丿丿丿丿
悲	非心丶ㄋ丶丶	非心丶ㄋ丶丶
拍	扌白丿丨ㄋ一	扌白丿丨ㄋ一
丁	于一丨丨丨丨	于一丨丨丨丨
赵	走乂丿丶丶丶	走乂丿丶丶丶
硬	石更一丨ㄋ一	石更一丨ㄋ一
麦	丰文丿ㄋ丶丶	丰文丿ㄋ丶丶
蒋	艹北丿ㄋ丶丶	艹北丿ㄋ丶丶
操	扌口丨ㄋ一丨	扌口丨ㄋ一丨
耶	耳耳ㄋ丨丨丨	耳耳ㄋ丨丨丨
阻	耳目丨ㄋ一一	耳目丨ㄋ一一
订	讠于一丨丨丨	讠于一丨丨丨
彩	爪木丿丿丿丿	爪木丿丿丿丿
抽	扌甲丨ㄋ一丨	扌甲丨ㄋ一丨
赞	先先丨ㄋ丿丶	先先丨ㄋ丿丶
魔	麻鬼丿丨ㄋ一	麻鬼丿丨ㄋ一
纷	纟分丿丶ㄋ丿	纟分丿丶ㄋ丿
沿	氵几丨ㄋ一一	氵几丨ㄋ一一
喊	口戊一丨ㄋ一	口戊一丨ㄋ一
违	韦辶丶ㄋ丶丶	韦辶丶ㄋ丶丶
妹	女未丨丿丶丶	女未丨丿丶丶
浪	氵笔ㄋ一一ㄋ	氵笔ㄋ一一ㄋ
汇	氵匚一ㄋㄋㄋ	氵匚一ㄋㄋㄋ
币	笔巾丨ㄋ丨丨	笔巾丨ㄋ丨丨
丰	丰一一一丨丨	丰一一一丨丨
蓝	艹丨ㄋ丨丨	艹丨ㄋ丨丨
殊	歹笔丨丿丶丶	歹笔丨丿丶丶
献	十冂丶丿一一	十冂丶丿一一
桌	卜日一丨丿丶	卜日一丨丿丶
啦	口扌丶一丶丿	口扌丶一丶丿
瓦	瓦一ㄋㄋ丶丶	瓦一ㄋㄋ丶丶
莱	艹夹丨丿丶丶	艹夹丨丿丶丶
援	扌爪一一丿ㄋ	扌爪一一丿ㄋ
译	讠双一一丨丨	讠双一一丨丨
夺	大寸一丨丶丶	大寸一丨丶丶
汽	氵气丿一一ㄋ	氵气丿一一ㄋ
烧	火尧一丿ㄋㄋ	火尧一丿ㄋㄋ
距	匚ㄋ一一一	匚ㄋ一一一
裁	衣丶一丿ㄋ	衣丶一丿ㄋ
偏	亻户丨ㄋ一丨	亻户丨ㄋ一丨
符	亻一丨丶丶	亻一丨丶丶
勇	甬力ㄋ丿丿丿	甬力ㄋ丿丿丿
触	角虫丨ㄋ一丨	角虫丨ㄋ一丨
课	讠日一丨丿丶	讠日一丨丿丶
敬	芍口丿一丿丶	芍口丿一丿丶
哭	吅犬一丿丶丶	吅犬一丿丶丶
懂	忄艹丿一丨丨	忄艹丿一丨丨
墙	土十丶丿一丨	土十丶丿一丨
袭	龙衣丶一丿ㄋ	龙衣丶一丿ㄋ
召	刀口丨ㄋ一一	刀口丨ㄋ一一
罚	四讠丨丨丨丨	四讠丨丨丨丨
侠	亻夹丿丶丶丶	亻夹丿丶丶丶
厅	广于一丨丨丨	广于一丨丨丨
拜	手笔一一一丨	手笔一一一丨
巧	工丂一ㄋㄋㄋ	工丂一ㄋㄋㄋ
侧	亻贝丨丨丨丨	亻贝丨丨丨丨
韩	韦一一ㄋ丨	韦一一ㄋ丨
冒	日目丨ㄋ一一	日目丨ㄋ一一
债	亻丰丨ㄋ丿丶	亻丰丨ㄋ丿丶
曼	日四ㄋ丶丶丶	日四ㄋ丶丶丶
融	鬲虫丨ㄋ一丨	鬲虫丨ㄋ一丨
惯	忄母丨ㄋ丿丶	忄母丨ㄋ丿丶
享	子ㄋ丨一一	子ㄋ丨一一
戴	田一丨丨一	田一丨丨一
童	立田丨ㄋ一一	立田丨ㄋ一一
犹	犬尢丶丶丶丶	犬尢丶丶丶丶
乘	禾北丨一一丿	禾北丨一一丿
挂	扌圭一丨一一	扌圭一丨一一
奖	北歹一丿丶丶	北歹一丿丶丶
绍	纟刀丨ㄋ一一	纟刀丨ㄋ一一
厚	广日ㄋ丨一一	广日ㄋ丨一一
纵	纟从丿丶丿丶	纟从丿丶丿丶
障	耳音一丨丨丨	耳音一丨丨丨
讯	讠乙一丨丨丨	讠乙一丨丨丨
涉	氵止丨丿丿丿	氵止丨丿丿丿
彻	彳七ㄋ丿丿丿	彳七ㄋ丿丿丿
刊	舌刂丨丨丨丨	舌刂丨丨丨丨
丈	石笔丶丶丶丶	石笔丶丶丶丶
爆	火日一丨丨一	火日一丨丨一
乌	勹㇉一一一一	勹Z一一一一
役	彳殳丿ㄋㄋ丶	彳殳丿ㄋㄋ丶
描	扌艹丨ㄋ一丨	扌艹丨ㄋ一丨
洗	氵先丿一丨一	氵先丿一丨一
玛	王马ㄋㄋ一一	王马ㄋㄋ一一
患	口中丶ㄋ丶丶	口中丶ㄋ丶丶
妙	女少丨丿丶丿	女少丨丿丶丿
镜	金音丿ㄋㄋㄋ	金音丿ㄋㄋㄋ
唱	口日丨ㄋ一一	口日丨ㄋ一一
烦	火页一丿丨ㄋ	火页一丿丨ㄋ
签	亼丶丶丿一	亼丶丶丿一
仙	亻山丨ㄋ丨丨	亻山丨ㄋ丨丨
彼	彳皮ㄋ丿丨ㄋ	彳皮ㄋ丿丨ㄋ
弗	弓刂丿丨丨丨	弓刂丿丨丨丨
症	疒正一丨一丨	疒正一丨一丨
仿	亻方丶一ㄋ丿	亻方丶一ㄋ丿
倾	亻七一丿丨ㄋ	亻七一丿丨ㄋ
牌	片卑丿丨ㄋ一	片卑丿丨ㄋ一
陷	耳鱼丿丨一ㄋ	耳鱼丿丨一ㄋ
鸟	鸟丿ㄋ丶ㄋㄋ	鸟丿ㄋ丶ㄋㄋ
轰	车双ㄋ丶ㄋ丶	车双ㄋ丶ㄋ丶
咱	口自丿丨ㄋ一	口自丿丨ㄋ一
菜	艹爪一丨丿丶	艹爪一丨丿丶
闭	门㇉一丨丿丿	门Z一丨丿丿
奋	大田丨ㄋ一丨	大田丨ㄋ一丨
庆	广大一丿丶丶	广大一丿丶丶
撤	扌亡丨ㄋ一一	扌亡丨ㄋ一一
泪	氵目丨ㄋ一一	氵目丨ㄋ一一
茶	艹人一丨丿丶	艹人一丨丿丶
疾	疒矢丿一一丿	疒矢丿一一丿
缘	纟彑丿ㄋ丿丿	纟彑丿ㄋ丿丿
播	扌釆丨ㄋ一丨	扌釆丨ㄋ一丨
朗	笔丿ㄋ一一	笔丿ㄋ一一
杜	木土一丨一一	木土一丨一一
奶	女乃ㄋ丿丿丿	女乃ㄋ丿丿丿
季	禾子ㄋ丨一一	禾子ㄋ丨一一
丹	冂亠丶一一一	冂亠丶一一一
狗	犬勹丨ㄋ一一	犬勹丨ㄋ一一
尾	尸毛丿一一ㄋ	尸毛丿一一ㄋ
仪	亻义丶丿丶丶	亻义丶丿丶丶
偷	亻亼丨ㄋ一一	亻亼丨ㄋ一一
奔	大十一丿丨丨	大十一丿丨丨
珠	王笔丨丿丶丶	王笔丨丿丶丶
虫	虫丨ㄋ一丨一	虫丨ㄋ一丨一
驻	马主丶一一丨	马主丶一一丨
孔	子乙ㄋㄋㄋㄋ	子乙ㄋㄋㄋㄋ
宜	宀目丨ㄋ一一	宀目丨ㄋ一一
艾	艹乂丿丶丶丶	艹乂丿丶丶丶
桥	木天丿丨丨丨	木天丿丨丨丨
淡	氵火丶丿丿丶	氵火丶丿丿丶
翼	羽田一丨丨一	羽田一丨丨一
恨	忄艮ㄋ一一ㄋ	忄艮ㄋ一一ㄋ
繁	母丿一丿丶	母丿一丿丶
寒	寒冫丶丶丶丶	寒冫丶丶丶丶
伴	亻半丶丿一一	亻半丶丿一一
叹	口双ㄋ丶丶丶	口双ㄋ丶丶丶
旦	旦丨ㄋ一一一	旦丨ㄋ一一一
愈	亼月丨丨丶ㄋ	亼月丨丨丶ㄋ
潮	氵丿ㄋ一一	氵丿ㄋ一一
粮	米笔ㄋ一一ㄋ	米笔ㄋ一一ㄋ
缩	纟宀丿丶丶丶	纟宀丿丶丶丶
罢	四去一丨一ㄋ	四去一丨一ㄋ
聚	耳双丿丨丿丿	耳双丿丨丿丿
径	彳轻ㄋ丶一丨	彳轻ㄋ丶一丨
恰	忄合丿丶一丨	忄合丿丶一丨
挑	扌儿丶一丿丶	扌儿丶一丿丶
袋	代衣丶一丿ㄋ	代衣丶一丿ㄋ
灰	石火丶丿丿丶	石火丶丿丿丶
捕	扌甫一丨ㄋ一	扌甫一丨ㄋ一
徐	彳亼一丨丿丶	彳亼一丨丿丶
珍	王人丿丿丿丿	王人丿丿丿丿
幕	莫巾丨ㄋ丨丨	莫巾丨ㄋ丨丨
映	日冂一丿丶丶	日冂一丿丶丶
裂	歹刂丶一丿ㄋ	歹刂丶一丿ㄋ
泰	水丨丶一丿	水丨丶一丿
隔	耳鬲一丨ㄋ一	耳鬲一丨ㄋ一
启	户口丨ㄋ一一	户口丨ㄋ一一
尖	小大一丿丶丶	小大一丿丶丶
忠	中心丶ㄋ丶丶	中心丶ㄋ丶丶
累	田糸ㄋㄋ丶丨	田糸ㄋㄋ丶丨
炎	火火丶丿丿丶	火火丶丿丿丶
暂	车丘丨ㄋ一一	车丘丨ㄋ一一
估	亻古一丨丨ㄋ	亻古一丨丨ㄋ
泛	氵笔丶ㄋ丶丶	氵笔丶ㄋ丶丶
荒	艹亡丿丨ㄋㄋ	艹亡丿丨ㄋㄋ
偿	亻丶ㄋ一一	亻丶ㄋ一一
横	木共丨ㄋ一丨	木共丨ㄋ一丨
拒	扌匚ㄋ一一一	扌匚ㄋ一一一
瑞	王山一丿丨ㄋ	王山一丿丨ㄋ
忆	忄乙ㄋㄋㄋㄋ	忄乙ㄋㄋㄋㄋ
孤	子爪丿丿ㄋ丶	子爪丿丿ㄋ丶
鼻	自田丨ㄋ一丨	自田丨ㄋ一丨
闹	门亠丨ㄋ丨丨	门亠丨ㄋ丨丨
羊	羊丶丿一一一	羊丶丿一一一
呆	呆丨ㄋ一一丨	呆丨ㄋ一一丨
厉	广力一ㄋ丿丿	广力一ㄋ丿丿
衡	彳鱼丨ㄋ一丨	彳鱼丨ㄋ一丨
胞	月勹ㄋ一ㄋㄋ	月勹ㄋ一ㄋㄋ
零	令丿丶丶ㄋ	令丿丶丶ㄋ
穷	穴力ㄋ丿丿丿	穴力ㄋ丿丿丿
舍	亼古一丨丨ㄋ	亼古一丨丨ㄋ
码	石马ㄋㄋ一一	石马ㄋㄋ一一
赫	赤赤丿丨丿丶	赤赤丿丨丿丶
婆	氵皮ㄋ丿一一	氵皮ㄋ丿一一
魂	云鬼丿丨ㄋ一	云鬼丿丨ㄋ一
灾	宀火丶丿丿丶	宀火丶丿丿丶
洪	氵共一丨丨一	氵共一丨丨一
腿	月艮丶ㄋ丶丶	月艮丶ㄋ丶丶
胆	月旦丨ㄋ一一	月旦丨ㄋ一一
津	氵聿ㄋ一一一	氵聿ㄋ一一一
俗	亻八丿丶丨ㄋ	亻八丿丶丨ㄋ
辩	辛讠丶一丶丿	辛讠丶一丶丿
胸	月勹丿丶ㄋ丨	月勹丿丶ㄋ丨
晓	日尧一丿ㄋㄋ	日尧一丿ㄋㄋ
劲	轻力ㄋ丿丿丿	轻力ㄋ丿丿丿
仁	亻二一一一一	亻二一一一一
贫	分贝丨ㄋ丿丶	分贝丨ㄋ丿丶
偶	亻日丨ㄋ丨一	亻日丨ㄋ丨一
辑	车口一丨丨一	车口一丨丨一
邦	丰耳ㄋ丨丨丨	丰耳ㄋ丨丨丨
恢	忄石丶丿丿丶	忄石丶丿丿丶
赖	束鱼丨ㄋ丿丶	束鱼丨ㄋ丿丶
圈	口ㄋㄋㄋㄋ	口ㄋㄋㄋㄋ
摸	扌莫一丨丨丨	扌莫一丨丨丨
仰	亻留ㄋ丨丨丨	亻留ㄋ丨丨丨
润	氵门一一丨一	氵门一一丨一
堆	土隹丿丨丶一	土隹丿丨丶一
碰	石䒑丨丨丶丿	石首丨丨丶丿
艇	舟王ㄋ丶丶丶	舟王ㄋ丶丶丶
稍	禾丨ㄋ一一	禾丨ㄋ一一
迟	尺辶丶ㄋ丶丶	尺辶丶ㄋ丶丶
辆	车丙丿丶丿丶	车丙丿丶丿丶
废	广发ㄋ丿ㄋ丶	广发ㄋ丿ㄋ丶
净	冫争丿ㄋㄋ一	冫争丿ㄋㄋ一
凶	乂冂ㄋ丨丨丨	乂冂ㄋ丨丨丨
署	四者一丨一丿	四者一丨一丿
壁	辟土一丨一一	辟土一丨一一
御	彳丨一丨一	彳丨一丨一
奉	土一一丨丨	土一一丨丨
旋	族走ㄋ丨一丿	族走ㄋ丨一丿
冬	文冫丶丶丶丶	文冫丶丶丶丶
矿	石广丶一丿丿	石广丶一丿丿
抬	扌厶丨ㄋ一一	扌厶丨ㄋ一一
蛋	走虫丨ㄋ一丨	走虫丨ㄋ一丨
晨	日辰一丿一一	日辰一丿一一
伏	亻犬一丿丶丶	亻犬一丿丶丶
吹	口欠丿ㄋ丿丶	口欠丿ㄋ丿丶
鸡	双鸟丿ㄋ丶ㄋ	双鸟丿ㄋ丶ㄋ
倍	亻立丨ㄋ一一	亻立丨ㄋ一一
糊	米古丿ㄋ一一	米古丿ㄋ一一
秦	禾一丨丿丶	禾一丨丿丶
盾	广十丨ㄋ一一	广十丨ㄋ一一
杯	木不一丿丨丶	木不一丿丨丶
租	禾目丨ㄋ一一	禾目丨ㄋ一一
骑	马大一丨ㄋ一	马大一丨ㄋ一
乏	笔之丶ㄋ丶丶	笔之丶ㄋ丶丶
隆	耳文一丿一一	耳文一丿一一
诊	讠人丿丿丿丿	讠人丿丿丿丿
奴	奴ㄋ丿一ㄋ丶	奴ㄋ丿一ㄋ丶
摄	扌耳ㄋ丶ㄋ丶	扌耳ㄋ丶ㄋ丶
丧	十䒑ㄋ丿丶丶	十首ㄋ丿丶丶
污	氵二ㄋㄋㄋㄋ	氵二ㄋㄋㄋㄋ
渡	氵度ㄋ丶丶丶	氵度ㄋ丶丶丶
旗	族其一丨丨一	族其一丨丨一
甘	甘一丨丨一一	甘一丨丨一一
耐	而寸一丨丶丶	而寸一丨丶丶
凭	亻王丿ㄋㄋㄋ	亻王丿ㄋㄋㄋ
扎	扌乙ㄋㄋㄋㄋ	扌乙ㄋㄋㄋㄋ
抢	扌人ㄋㄋㄋㄋ	扌人ㄋㄋㄋㄋ
绪	纟者一丨一丿	纟者一丨一丿
粗	米目丨ㄋ一一	米目丨ㄋ一一
肩	户月丨ㄋ一一	户月丨ㄋ一一
梁	氵刀丿丶一丨	氵刀丿丶一丨
幻	幺㇉ㄋㄋㄋㄋ	幺Zㄋㄋㄋㄋ
菲	艹非丨一一一	艹非丨一一一
皆	比白丿丨ㄋ一	比白丿丨ㄋ一
碎	石亠丿丶丿丶	石亠丿丶丿丶
宙	宀甲丨ㄋ一丨	宀甲丨ㄋ一丨
叔	上小ㄋ丶丶丶	上小ㄋ丶丶丶
岩	山石一丿丨ㄋ	山石一丿丨ㄋ
荡	落㇉丿丿丿丿	落Z丿丿丿丿
综	纟宀一一丨丿	纟宀一一丨丿
爬	爪巴ㄋ丨一ㄋ	爪巴ㄋ丨一ㄋ
荷	荷可一丨ㄋ一	荷可一丨ㄋ一
悉	釆心丶ㄋ丶丶	釆心丶ㄋ丶丶
蒂	艹立丨ㄋ丨丨	艹立丨ㄋ丨丨
返	广双丶ㄋ丶丶	广双丶ㄋ丶丶
井	二一一丿丨丨	二一一丿丨丨
壮	北土一丨一一	北土一丨一一
薄	落甫一丨丶丶	落甫一丨丶丶
悄	忄丨ㄋ一一	忄丨ㄋ一一
扫	扌尹ㄋ一一一	扌尹ㄋ一一一
敏	母丿一丿丶	母丿一丿丶
碍	石旦一丨丶丶	石旦一丨丶丶
殖	歹直一丨丨ㄋ	歹直一丨丨ㄋ
详	讠羊丶丿一一	讠羊丶丿一一
迪	甲辶丶ㄋ丶丶	甲辶丶ㄋ丶丶
矛	矛ㄋ丶ㄋ丨丿	矛ㄋ丶ㄋ丨丿
霍	隹丿丨丶一	隹丿丨丶一
允	厶儿丿ㄋㄋㄋ	厶儿丿ㄋㄋㄋ
幅	巾鬲丨ㄋ一丨	巾鬲丨ㄋ一丨
撒	扌共丨ㄋ一一	扌共丨ㄋ一一
剩	禾北丨丨丨丨	禾北丨丨丨丨
凯	山巴丿ㄋㄋㄋ	山巴丿ㄋㄋㄋ
颗	日木一丿丿丿	日木一丿丿丿
骂	吅马ㄋㄋ一一	吅马ㄋㄋ一一
赏	贝丨ㄋ丿丶	贝丨ㄋ丿丶
液	氵亠丿丶丿ㄋ	氵亠丿丶丿ㄋ
番	釆田丨ㄋ一丨	釆田丨ㄋ一丨
箱	相一丨丿丶	相一丨丿丶
贴	贝占丨一丨ㄋ	贝占丨一丨ㄋ
漫	氵日丨ㄋ丨丨	氵日丨ㄋ丨丨
酸	西厶丿丶丿ㄋ	西厶丿丶丿ㄋ
郎	笔ㄋ丨丨丨	笔ㄋ丨丨丨
腰	月西ㄋ丿一一	月西ㄋ丿一一
舒	亼古ㄋ丶ㄋ丨	亼古ㄋ丶ㄋ丨
眉	尸目丨ㄋ一一	尸目丨ㄋ一一
忧	忄尢丶丶丶丶	忄尢丶丶丶丶
浮	氵爪ㄋ丨一一	氵爪ㄋ丨一一
辛	辛丶一丶丿一	辛丶一丶丿一
恋	亦心丶ㄋ丶丶	亦心丶ㄋ丶丶
餐	卜歹ㄋ丶丿丶	卜歹ㄋ丶丿丶
吓	口下一丨丶丶	口下一丨丶丶
挺	扌王ㄋ丶丶丶	扌王ㄋ丶丶丶
励	广力ㄋ丿丿丿	广力ㄋ丿丿丿
辞	舌辛丶一丶丿	舌辛丶一丶丿
艘	舟鼠丨ㄋ丶丶	舟鼠丨ㄋ丶丶
键	金聿ㄋ丶丶丶	金聿ㄋ丶丶丶
伍	亻五一丨ㄋ一	亻五一丨ㄋ一
峰	山文一一一丨	山文一一一丨
尺	尺ㄋ一丿丶丶	尺ㄋ一丿丶丶
昨	日乍丿一丨一	日乍丿一丨一
黎	禾勹丿丨丶一	禾勹丿丨丶一
辈	非车一ㄋ一丨	非车一ㄋ一丨
贯	母贝丨ㄋ丿丶	母贝丨ㄋ丿丶
侦	亻卜丨ㄋ丿丶	亻卜丨ㄋ丿丶
滑	氵骨丨ㄋㄋ丶	氵骨丨ㄋㄋ丶
券	刀ㄋ丿丿丿	刀ㄋ丿丿丿
崇	山宀一一丨丿	山宀一一丨丿
扰	扌尢丶丶丶丶	扌尢丶丶丶丶
宪	宀先丿一丨一	宀先丿一丨一
绕	纟尧一ㄋ丿一	纟尧一ㄋ丿一
趋	走刍丿ㄋㄋ一	走刍丿ㄋㄋ一
慈	䒑幺ㄋㄋ丶丶	首幺ㄋㄋ丶丶
乔	天刂丿丨丨丨	天刂丿丨丨丨
阅	门𠮦丿ㄋㄋㄋ	门兑丿ㄋㄋㄋ
汗	氵舌一一丨丨	氵舌一一丨丨
枝	木十ㄋ丶丶丶	木十ㄋ丶丶丶
拖	扌ㄋ丨ㄋㄋ	扌ㄋ丨ㄋㄋ
墨	黑土一丨一一	黑土一丨一一
胁	月力丿丶丶丶	月力丿丶丶丶
插	扌舌丿丨一ㄋ	扌舌丿丨一ㄋ
箭	前丶丿一丨	前丶丿一丨
腊	月共丨ㄋ一一	月共丨ㄋ一一
粉	米分丿丶ㄋ丿	米分丿丶ㄋ丿
泥	氵尸丿ㄋㄋㄋ	氵尸丿ㄋㄋㄋ
氏	氏丿ㄋ一ㄋㄋ	氏丿ㄋ一ㄋㄋ
彭	壴川丿丿丿丿	壴川丿丿丿丿
拔	扌石ㄋ丶丶丶	扌石ㄋ丶丶丶
骗	马户丨ㄋ一丨	马户丨ㄋ一丨
凤	几双ㄋ丶丶丶	几双ㄋ丶丶丶
慧	丰丰ㄋ一一丶	丰丰ㄋ一一丶
媒	女甘一丨丿丶	女甘一丨丿丶
佩	亻几一丨ㄋ丨	亻几一丨ㄋ丨
愤	忄十一丨丨丨	忄十一丨丨丨
扑	扌卜丨丶丶丶	扌卜丨丶丶丶
龄	止令丿丶丶ㄋ	止令丿丶丶ㄋ
驱	马区一丿丶ㄋ	马区一丿丶ㄋ
惜	忄共丨ㄋ一一	忄共丨ㄋ一一
豪	豕一丿ㄋ丿	豕一丿ㄋ丿
掩	扌大丨ㄋ一一	扌大丨ㄋ一一
兼	兼丶丿一ㄋ一	兼丶丿一ㄋ一
跃	天丿一丿丶	天丿一丿丶
尸	尸ㄋ一丿丿丿	尸ㄋ一丿丿丿
肃	聿刂丿丶丶丶	聿刂丿丶丶丶
帕	巾白丿丨ㄋ一	巾白丿丨ㄋ一
驶	马口丿丶丶丶	马口丿丶丶丶
堡	亻呆一丨一一	亻呆一丨一一
届	尸甲丨ㄋ一丨	尸甲丨ㄋ一丨
欣	丘欠丿ㄋ丿丶	丘欠丿ㄋ丿丶
惠	笔日丨一丶丶	笔日丨一丶丶
册	冂冂一一一一	冂冂一一一一
储	亻讠一丨一丿	亻讠一丨一丿
飘	西示丿ㄋ丿丶	西示丿ㄋ丿丶
桑	双双一丨丿丶	双双一丨丿丶
闲	门木一丨丿丶	门木一丨丿丶
惨	忄厶丿丿丿丿	忄厶丿丿丿丿
洁	氵吉一丨一丨	氵吉一丨一丨
踪	宀一一丨丿	宀一一丨丿
勃	子ㄋ丿丿丿	子ㄋ丿丿丿
宾	宀丘丿丶丶丶	宀丘丿丶丶丶
频	止小一丿丨ㄋ	止小一丿丨ㄋ
仇	亻九丿ㄋㄋㄋ	亻九丿ㄋㄋㄋ
磨	麻石一丿丨ㄋ	麻石一丿丨ㄋ
递	弓辶丶ㄋ丶丶	弓辶丶ㄋ丶丶
邪	牙耳ㄋ丨丨丨	牙耳ㄋ丨丨丨
撞	扌立丨ㄋ一一	扌立丨ㄋ一一
拟	扌以ㄋ丶丿丶	扌以ㄋ丶丿丶
滚	氵六ㄋ丶丶丶	氵六ㄋ丶丶丶
奏	天丿一丿丶	天丿一丿丶
巡	川辶丶ㄋ丶丶	川辶丶ㄋ丶丶
颜	立广丿丿丿一	立广丿丿丿一
剂	文刂丨丨丨丨	文刂丨丨丨丨
绩	纟丰丨ㄋ丿丶	纟丰丨ㄋ丿丶
贡	工贝丨ㄋ丿丶	工贝丨ㄋ丿丶
疯	疒几丿丶丶丶	疒几丿丶丶丶
坡	土皮ㄋ丿丨ㄋ	土皮ㄋ丿丨ㄋ
瞧	目隹丶丶丶丶	目隹丶丶丶丶
截	隹丿丨丶一	隹丿丨丶一
燃	火歹一丿丶丶	火歹一丿丶丶
焦	隹水丶丶丶丶	隹水丶丶丶丶
殿	尸共丿ㄋㄋ丶	尸共丿ㄋㄋ丶
伪	亻笔ㄋ丿丶丶	亻笔ㄋ丿丶丶
柳	木留丿ㄋ丿ㄋ	木留丿ㄋ丿ㄋ
锁	金丨ㄋ丿丶	金丨ㄋ丿丶
逼	鬲田丶ㄋ丶丶	鬲田丶ㄋ丶丶
颇	皮页一丿丨ㄋ	皮页一丿丨ㄋ
昏	氏日丨ㄋ一一	氏日丨ㄋ一一
劝	双力ㄋ丿丿丿	双力ㄋ丿丿丿
呈	口王一一丨一	口王一一丨一
搜	扌鼠丨ㄋ丶丶	扌鼠丨ㄋ丶丶
勤	堇力ㄋ丿丿丿	堇力ㄋ丿丿丿
戒	戋开一丿丨丨	戋开一丿丨丨
驾	加马ㄋㄋ一一	加马ㄋㄋ一一
漂	氵西一一丨丿	氵西一一丨丿
饮	食欠丿ㄋ丿丶	食欠丿ㄋ丿丶
曹	笔甲丨ㄋ一一	笔甲丨ㄋ一一
朵	几木一丨丿丶	几木一丨丿丶
仔	亻子ㄋ丨一一	亻子ㄋ丨一一
柔	矛木一丨丿丶	矛木一丨丿丶
俩	亻丙丿丶丿丶	亻丙丿丶丿丶
孟	子四丨ㄋ丨丨	子四丨ㄋ丨丨
腐	广亻一丨丶丨	广亻一丨丶丨
幼	幺力ㄋ丿丿丿	幺力ㄋ丿丿丿
践	戋一一ㄋ丿	戋一一ㄋ丿
籍	未一丨丨一	未一丨丨一
牧	牛文丿一丿丶	牛文丿一丿丶
凉	冫京丶一丨ㄋ	冫京丶一丨ㄋ
牲	牛生丿一一丨	牛生丿一一丨
佳	亻圭一丨一一	亻圭一丨一一
娜	女刀ㄋ丨丨丨	女刀ㄋ丨丨丨
浓	氵农丶ㄋ丿ㄋ	氵农丶ㄋ丿ㄋ
芳	艹方丶一ㄋ丿	艹方丶一ㄋ丿
稿	禾丨ㄋ一一	禾丨ㄋ一一
竹	丿一丨丿一	丿一丨丿一
腹	月丨ㄋ一一	月丨ㄋ一一
跌	笔一一丿丶	笔一一丿丶
逻	四歹丶ㄋ丶丶	四歹丶ㄋ丶丶
垂	垂丿一丨一丨	垂丿一丨一丨
遵	酋寸丶ㄋ丶丶	酋寸丶ㄋ丶丶
脉	月笔ㄋㄋ丿丶	月笔ㄋㄋ丿丶
貌	豸白丿ㄋㄋㄋ	豸白丿ㄋㄋㄋ
柏	木白丿丨ㄋ一	木白丿丨ㄋ一
狱	犬讠一丿丶丶	犬讠一丿丶丶
猜	犬青一一丨一	犬青一一丨一
怜	忄令丿丶丶ㄋ	忄令丿丶丶ㄋ
惑	戋口一丶ㄋ丶	戋口一丶ㄋ丶
陶	耳勹丿一一丨	耳勹丿一一丨
兽	冫田一丨ㄋ一	冫田一丨ㄋ一
帐	巾长丿一ㄋ丶	巾长丿一ㄋ丶
饰	食丨ㄋ丨丨	食丨ㄋ丨丨
贷	代贝丨ㄋ丿丶	代贝丨ㄋ丿丶
昌	日日丨ㄋ一一	日日丨ㄋ一一
叙	亼木ㄋ丶丶丶	亼木ㄋ丶丶丶
躺	身丨ㄋ丨ㄋ	身丨ㄋ丨ㄋ
钢	金冂丿丶丶丶	金冂丿丶丶丶
沟	氵勹ㄋ丶丶丶	氵勹ㄋ丶丶丶
寄	宀大一丨ㄋ一	宀大一丨ㄋ一
扶	扌夫一一丿丶	扌夫一一丿丶
铺	金甫一丨ㄋ一	金甫一丨ㄋ一
邓	双耳ㄋ丨丨丨	双耳ㄋ丨丨丨
寿	丰寸一丨丶丶	丰寸一丨丶丶
惧	忄目丿丶丶丶	忄目丿丶丶丶
询	讠勹丨ㄋ一一	讠勹丨ㄋ一一
汤	氵㇉丿丿丿丿	氵Z丿丿丿丿
盗	次四丨ㄋ丨丨	次四丨ㄋ丨丨
肥	月巴ㄋ丨一ㄋ	月巴ㄋ丨一ㄋ
尝	冖一一ㄋ丶	冖一一ㄋ丶
匆	勿笔丶丶丶丶	勿笔丶丶丶丶
辉	光冖一ㄋ一丨	光冖一ㄋ一丨
奈	大示一一丨丿	大示一一丨丿
扣	扌口丨ㄋ一一	扌口丨ㄋ一一
廷	王辶ㄋ丶丶丶	王辶ㄋ丶丶丶
澳	氵丶丿一丨	氵丶丿一丨
嘛	口麻丶一丿一	口麻丶一丿一
董	艹舌丨ㄋ一一	艹舌丨ㄋ一一
迁	舌辶丶ㄋ丶丶	舌辶丶ㄋ丶丶
凝	冫七丿一一丿	冫七丿一一丿
慰	尸示一丨丶丶	尸示一丨丶丶
厌	广犬一丿丶丶	广犬一丿丶丶
脏	月广一丨一一	月广一丨一一
腾	月ㄋㄋ一一	月ㄋㄋ一一
幽	山幺ㄋㄋ丶丶	山幺ㄋㄋ丶丶
怨	歹巴丶ㄋ丶丶	歹巴丶ㄋ丶丶
鞋	革圭一丨一一	革圭一丨一一
丢	笔去一丨一ㄋ	笔去一丨一ㄋ
埋	土田丨ㄋ一一	土田丨ㄋ一一
泉	白水丨ㄋ丿丶	白水丨ㄋ丿丶
涌	氵甬ㄋ丶丨ㄋ	氵甬ㄋ丶丨ㄋ
辖	车宀一一一丨	车宀一一一丨
躲	身几一丨丿丶	身几一丨丿丶
晋	亚日丨ㄋ一一	亚日丨ㄋ一一
紫	此糸ㄋㄋ丶丨	此糸ㄋㄋ丶丨
艰	双艮ㄋ一一ㄋ	双艮ㄋ一一ㄋ
魏	禾女丿丨ㄋ一	禾女丿丨ㄋ一
吾	五口丨ㄋ一一	五口丨ㄋ一一
慌	忄艹丶一ㄋ丿	忄艹丶一ㄋ丿
祝	衤口丿ㄋㄋㄋ	衤口丿ㄋㄋㄋ
邮	甲耳ㄋ丨丨丨	甲耳ㄋ丨丨丨
吐	口土一丨一一	口土一丨一一
狠	犬艮ㄋ一一ㄋ	犬艮ㄋ一一ㄋ
鉴	金丿丶一一	金丿丶一一
曰	日丨ㄋ一一一	日丨ㄋ一一一
械	木戋一丿丨丨	木戋一丿丨丨
咬	口六丿丶丶丶	口六丿丶丶丶
邻	令耳ㄋ丨丨丨	令耳ㄋ丨丨丨
赤	赤丿丨丿丶丶	赤丿丨丿丶丶
挤	扌文丿丨丨丨	扌文丿丨丨丨
椅	木大一丨ㄋ一	木大一丨ㄋ一
弯	亦弓ㄋ一ㄋㄋ	亦弓ㄋ一ㄋㄋ
陪	耳立丨ㄋ一一	耳立丨ㄋ一一
割	宀丰丨ㄋ一丨	宀丰丨ㄋ一丨
揭	扌日丿ㄋ丿丶	扌日丿ㄋ丿丶
韦	韦一一ㄋ丨丨	韦一一ㄋ丨丨
悟	忄五丨ㄋ一一	忄五丨ㄋ一一
聪	耳𠮦丶ㄋ丶丶	耳兑丶ㄋ丶丶
雾	文ㄋ丿丿丿	文ㄋ丿丿丿
锋	金文一一一丨	金文一一一丨
梯	木弓丶丿ㄋ一	木弓丶丿ㄋ一
祥	衤羊丶丿一一	衤羊丶丿一一
猫	犬艹丨ㄋ一丨	犬艹丨ㄋ一丨
阔	门氵丿一丨丨	门氵丿一丨丨
誉	八丶一一一	八丶一一一
筹	丰一丨丶丶	丰一丨丶丶
丛	从笔一一一一	从笔一一一一
牵	大冖丿一一丨	大冖丿一一丨
鸣	口鸟丿ㄋ丶ㄋ	口鸟丿ㄋ丶ㄋ
沈	氵冖丿ㄋㄋㄋ	氵冖丿ㄋㄋㄋ
阁	门各丿ㄋ丶丨	门各丿ㄋ丶丨
穆	禾白丨丿丶丿	禾白丨丿丶丿
屈	尸山ㄋ丨丨丨	尸山ㄋ丨丨丨
旨	七日丨ㄋ一一	七日丨ㄋ一一
袖	衤甲丨ㄋ一丨	衤甲丨ㄋ一丨
猎	犬共丨ㄋ一一	犬共丨ㄋ一一
臂	辟月丨ㄋ一一	辟月丨ㄋ一一
蛇	虫宀丿ㄋㄋㄋ	虫宀丿ㄋㄋㄋ
贺	加贝丨ㄋ丿丶	加贝丨ㄋ丿丶
柱	木主丶一一丨	木主丶一一丨
抛	扌九ㄋ丿丿丿	扌九ㄋ丿丿丿
鼠	鼠丿丨一ㄋ一	鼠丿丨一ㄋ一
瑟	王王丶ㄋ丶丿	王王丶ㄋ丶丿
戈	戋一ㄋ丿丶丶	戋一ㄋ丿丶丶
牢	宀牛丿一一丨	宀牛丿一一丨
逊	子小丶ㄋ丶丶	子小丶ㄋ丶丶
迈	力辶丶ㄋ丶丶	力辶丶ㄋ丶丶
欺	其欠丿ㄋ丿丶	其欠丿ㄋ丿丶
吨	口屯一ㄋ丨ㄋ	口屯一ㄋ丨ㄋ
琴	王王丿丶丶ㄋ	王王丿丶丶ㄋ
衰	笔丿ㄋ丿丶	笔丿ㄋ丿丶
瓶	䒑开一ㄋㄋ丶	首开一ㄋㄋ丶
恼	忄㐫丶一丿丶	忄离丶一丿丶
燕	甘口丨一一丿	甘口丨一一丿
仲	亻中丨ㄋ一丨	亻中丨ㄋ一丨
诱	讠禾ㄋ丿丿丿	讠禾ㄋ丿丿丿
狼	犬笔ㄋ一一ㄋ	犬笔ㄋ一一ㄋ
池	氵也ㄋ丨ㄋㄋ	氵也ㄋ丨ㄋㄋ
疼	疒文丶丶丶丶	疒文丶丶丶丶
卢	卜尸ㄋ一丿丿	卜尸ㄋ一丿丿
仗	亻石丶丶丶丶	亻石丶丶丶丶
冠	冖元一丨丶丶	冖元一丨丶丶
粒	米立丶一丶丿	米立丶一丶丿
遥	爪缶丶ㄋ丶丶	爪缶丶ㄋ丶丶
吕	口口丨ㄋ一一	口口丨ㄋ一一
玄	亠幺ㄋㄋ丶丶	亠幺ㄋㄋ丶丶
尘	小土一丨一一	小土一丨一一
冯	冫马ㄋㄋ一一	冫马ㄋㄋ一一
抚	扌笔一丿ㄋㄋ	扌笔一丿ㄋㄋ
浅	氵戋一一ㄋ丿	氵戋一一ㄋ丿
敦	子丿一丿丶	子丿一丿丶
钻	金占丨一丨ㄋ	金占丨一丨ㄋ
纠	纟丩ㄋ丨丨丨	纟丩ㄋ丨丨丨
晶	日日丨ㄋ一一	日日丨ㄋ一一
岂	山巴ㄋ一ㄋㄋ	山巴ㄋ一ㄋㄋ
峡	山夹丿丶丶丶	山夹丿丶丶丶
苍	艹人ㄋㄋㄋㄋ	艹人ㄋㄋㄋㄋ
喷	口十一丨丨丨	口十一丨丨丨
凌	冫土丿丶丿ㄋ	冫土丿丶丿ㄋ
耗	未毛丿一一ㄋ	未毛丿一一ㄋ
敲	口丨一ㄋ丶	口丨一ㄋ丶
菌	艹口一丨丿丶	艹口一丨丿丶
赔	贝立丨ㄋ一一	贝立丨ㄋ一一
涂	氵亼一丨丿丶	氵亼一丨丿丶
粹	米亠丿丶丿丶	米亠丿丶丿丶
扁	户丨ㄋ一丨	户丨ㄋ一丨
亏	二㇉ㄋㄋㄋㄋ	二Zㄋㄋㄋㄋ
寂	宀上丨丿丶ㄋ	宀上丨丿丶ㄋ
煤	火甘一丨丿丶	火甘一丨丿丶
熊	厶月丿ㄋ丿ㄋ	厶月丿ㄋ丿ㄋ
恭	共小丨丶丶丶	共小丨丶丶丶
湿	氵日丨丨丶丿	氵日丨丨丶丿
循	彳广一丨丨ㄋ	彳广一丨丨ㄋ
暖	日爪一一丿ㄋ	日爪一一丿ㄋ
糖	米广ㄋ一一丨	米广ㄋ一一丨
赋	贝笔一ㄋ丶丨	贝笔一ㄋ丶丨
抑	扌留ㄋ丨丨丨	扌留ㄋ丨丨丨
秩	禾笔一一丿丶	禾笔一一丿丶
帽	巾日丨ㄋ一一	巾日丨ㄋ一一
哀	衣丿ㄋ丿丶	衣丿ㄋ丿丶
宿	宀亻一丿丨ㄋ	宀亻一丿丨ㄋ
踏	水丨ㄋ一一	水丨ㄋ一一
烂	火䒑一一一一	火首一一一一
袁	土口丿ㄋ丿丶	土口丿ㄋ丿丶
侯	亻匚丿一一丿	亻匚丿一一丿
抖	扌冫一丨丨丨	扌冫一丨丨丨
夹	夹人丿丶丶丶	夹人丿丶丶丶
昆	日比一ㄋ丿ㄋ	日比一ㄋ丿ㄋ
肝	月舌一一丨丨	月舌一一丨丨
擦	扌宀丿ㄋ丶丶	扌宀丿ㄋ丶丶
猪	犬者一丨一丿	犬者一丨一丿
炼	火车ㄋ丿丶丶	火车ㄋ丿丶丶
恒	忄笔丨ㄋ一一	忄笔丨ㄋ一一
慎	忄直丿丶丶丶	忄直丿丶丶丶
搬	扌舟丿ㄋㄋ丶	扌舟丿ㄋㄋ丶
纽	纟丑ㄋ丨一一	纟丑ㄋ丨一一
纹	纟文丶一丿丶	纟文丶一丿丶
玻	王皮ㄋ丿丨ㄋ	王皮ㄋ丿丨ㄋ
渔	氵鱼丿ㄋ丨ㄋ	氵鱼丿ㄋ丨ㄋ
磁	石䒑ㄋㄋ丶ㄋ	石首ㄋㄋ丶ㄋ
铜	金冂一丨ㄋ一	金冂一丨ㄋ一
齿	止丨一丨一丿	止丨一丨一丿
跨	大一一ㄋㄋ	大一一ㄋㄋ
押	扌甲丨ㄋ一一	扌甲丨ㄋ一一
怖	忄石丨ㄋ丨丨	忄石丨ㄋ丨丨
漠	氵莫一丨丨丨	氵莫一丨丨丨
疲	疒皮ㄋ丿丨ㄋ	疒皮ㄋ丿丨ㄋ
叛	半广ㄋ丶丶丶	半广ㄋ丶丶丶
遣	吅丶ㄋ丶丶	吅丶ㄋ丶丶
兹	䒑幺ㄋㄋ丶丶	首幺ㄋㄋ丶丶
祭	示一一丨丿	祭示一一丨丿
醉	西亠丿丶丿丶	西亠丿丶丿丶
拳	手丿一一丨	手丿一一丨
弥	弓尔丿ㄋ丨丿	弓尔丿ㄋ丨丿
斜	亼木丶丶一丨	亼木丶丶一丨
档	木ㄋ一一一	木ㄋ一一一
稀	禾乂丨ㄋ丨丨	禾乂丨ㄋ丨丨
捷	扌笔ㄋ一一丨	扌笔ㄋ一一丨
肤	月夫一一丿丶	月夫一一丿丶
肿	月中丨ㄋ一丨	月中丨ㄋ一丨
疫	疒殳丿ㄋㄋ丶	疒殳丿ㄋㄋ丶
豆	豆一丨ㄋ一丶	豆一丨ㄋ一丶
削	月丨丨丨丨	月丨丨丨丨
岗	山冂丿丶丶丶	山冂丿丶丶丶
晃	日光丨丶丿一	日光丨丶丿一
吞	天口丨ㄋ一一	天口丨ㄋ一一
宏	宀石ㄋ丶丶丶	宀石ㄋ丶丶丶
癌	疒口丨ㄋ一丨	疒口丨ㄋ一丨
肚	月土一丨一一	月土一丨一一
隶	尹水丨丶一丿	尹水丨丶一丿
履	尸彳丿一丨ㄋ	尸彳丿一丨ㄋ
涨	氵弓丿一ㄋ丶	氵弓丿一ㄋ丶
耀	光羽丿丨丶一	光羽丿丨丶一
扭	扌丑ㄋ丨一一	扌丑ㄋ丨一一
坛	土云一一ㄋ丶	土云一一ㄋ丶
沃	氵天丿一丿丶	氵天丿一丿丶
拨	扌发ㄋ丿ㄋ丶	扌发ㄋ丿ㄋ丶
绘	纟人一一ㄋ丶	纟人一一ㄋ丶
伐	亻戋一ㄋ丿丶	亻戋一ㄋ丿丶
堪	土其ㄋㄋㄋㄋ	土其ㄋㄋㄋㄋ
仆	亻卜丨丶丶丶	亻卜丨丶丶丶
郭	子ㄋ丨丨丨	子ㄋ丨丨丨
牺	牛西一丨ㄋ丿	牛西一丨ㄋ丿
歼	歹舌丿一丨丨	歹舌丿一丨丨
墓	莫土一丨一一	莫土一丨一一
雇	户隹丿丨丶一	户隹丿丨丶一
廉	广兼丶丿一ㄋ	广兼丶丿一ㄋ
契	丰刀一丿丶丶	丰刀一丿丶丶
拼	扌䒑一丿丨丨	扌首一丿丨丨
惩	彳正丶ㄋ丶丶	彳正丶ㄋ丶丶
捉	扌口丨一丿丶	扌口丨一丿丶
覆	西彳丿一丨ㄋ	西彳丿一丨ㄋ
刷	尸巾丨丨丨丨	尸巾丨丨丨丨
劫	去力ㄋ丿丿丿	去力ㄋ丿丿丿
嫌	女兼丶丿一ㄋ	女兼丶丿一ㄋ
瓜	爪丿丿ㄋ丶丶	爪丿丿ㄋ丶丶
歇	日勹丿丶ㄋ丿	日勹丿丶ㄋ丿
雕	冂吉丿丨丶一	冂吉丿丨丶一
闷	门心丶ㄋ丶丶	门心丶ㄋ丶丶
乳	爪子ㄋㄋㄋㄋ	爪子ㄋㄋㄋㄋ
串	口中丨ㄋ一丨	口中丨ㄋ一丨
娃	女圭一丨一一	女圭一丨一一
缴	纟白丶一ㄋ丿	纟白丶一ㄋ丿
唤	口鱼丨ㄋ一丿	口鱼丨ㄋ一丿
赢	赢贝丨ㄋ丿丶	赢贝丨ㄋ丿丶
莲	艹车丶ㄋ丶丶	艹车丶ㄋ丶丶
桃	木儿丶一丿丶	木儿丶一丿丶
霸	革丿ㄋ一一	革丿ㄋ一一
妥	爪女ㄋ丿一一	爪女ㄋ丿一一
瘦	疒鼠丨ㄋ丶丶	疒鼠丨ㄋ丶丶
搭	扌艹丿丶一丨	扌艹丿丶一丨
赴	走卜丨丶丶丶	走卜丨丶丶丶
岳	丘山丨ㄋ丨丨	丘山丨ㄋ丨丨
嘉	壴加ㄋ丿丨ㄋ	壴加ㄋ丿丨ㄋ
舱	舟人ㄋㄋㄋㄋ	舟人ㄋㄋㄋㄋ
俊	亻厶丿丶丿ㄋ	亻厶丿丶丿ㄋ
址	土止丨一丨一	土止丨一丨一
庞	广龙一丿ㄋ丿	广龙一丿ㄋ丿
耕	未二一一丿丨	未二一一丿丨
锐	金𠮦丿ㄋㄋㄋ	金兑丿ㄋㄋㄋ
缝	纟文一一一丨	纟文一一一丨
悔	忄ㄋㄋ丶一	忄ㄋㄋ丶一
邀	白方丿一丿丶	白方丿一丿丶
玲	王令丿丶丶ㄋ	王令丿丶丶ㄋ
惟	忄隹丿丨丶一	忄隹丿丨丶一
宅	宀笔一ㄋㄋㄋ	宀笔一ㄋㄋㄋ
斥	丘笔丶丶丶丶	丘笔丶丶丶丶
添	氵天丨丶丶丶	氵天丨丶丶丶
挖	扌穴ㄋㄋㄋㄋ	扌穴ㄋㄋㄋㄋ
呵	口可一丨ㄋ一	口可一丨ㄋ一
讼	讠公丿丶ㄋ丶	讠公丿丶ㄋ丶
氧	气羊丶丿一一	气羊丶丿一一
浩	氵告丿一丨一	氵告丿一丨一
羽	羽ㄋ丶一ㄋ丶	羽ㄋ丶一ㄋ丶
斤	丘丿丿一丨丨	丘丿丿一丨丨
酷	西告丿一丨一	西告丿一丨一
掠	扌京丶一丨ㄋ	扌京丶一丨ㄋ
妖	女天丿一丿丶	女天丿一丿丶
祸	衤口丨ㄋ丿丶	衤口丨ㄋ丿丶
侍	亻土一丨丶丶	亻土一丨丶丶
乙	乙ㄋㄋㄋㄋㄋ	乙ㄋㄋㄋㄋㄋ
妨	女方丶一ㄋ丿	女方丶一ㄋ丿
贪	令贝丨ㄋ丿丶	令贝丨ㄋ丿丶
挣	扌争丿ㄋㄋ一	扌争丿ㄋㄋ一
汪	氵王一一丨一	氵王一一丨一
尿	尸水丨ㄋ丿丶	尸水丨ㄋ丿丶
莉	艹禾丨丨丨丨	艹禾丨丨丨丨
悬	目厶丶ㄋ丶丶	目厶丶ㄋ丶丶
唇	辰口丨ㄋ一一	辰口丨ㄋ一一
翰	人ㄋ丶一ㄋ	人ㄋ丶一ㄋ
仓	人巴ㄋㄋㄋㄋ	人巴ㄋㄋㄋㄋ
轨	车九丿ㄋㄋㄋ	车九丿ㄋㄋㄋ
枚	木文丿一丿丶	木文丿一丿丶
盐	土卜丨ㄋ丨丨	土卜丨ㄋ丨丨
览	见丨ㄋ丿ㄋ	见丨ㄋ丿ㄋ
傅	亻甫一丨丶丶	亻甫一丨丶丶
帅	刂巾丨ㄋ丨丨	刂巾丨ㄋ丨丨
庙	广甲丨ㄋ一丨	广甲丨ㄋ一丨
芬	艹分丿丶ㄋ丿	艹分丿丶ㄋ丿
屏	尸䒑一丿丨丨	尸首一丿丨丨
寺	土寸一丨丶丶	土寸一丨丶丶
胖	月半丶丿一一	月半丶丿一一
璃	王㐫丨ㄋㄋ丶	王离丨ㄋㄋ丶
愚	日内丶ㄋ丶丶	日内丶ㄋ丶丶
滴	氵立丨ㄋ一丨	氵立丨ㄋ一丨
疏	㇉止丶一ㄋ丶	Z止丶一ㄋ丶
萧	艹聿丿丶丿丨	艹聿丿丶丿丨
姿	次女ㄋ丿一一	次女ㄋ丿一一
颤	亠回丨ㄋ一一	亠回丨ㄋ一一
丑	丑ㄋ丨一一一	丑ㄋ丨一一一
劣	少力ㄋ丿丿丿	少力ㄋ丿丿丿
柯	木可一丨ㄋ一	木可一丨ㄋ一
寸	寸一丨丶丶丶	寸一丨丶丶丶
扔	扌乃ㄋ丿丿丿	扌乃ㄋ丿丿丿
盯	目于一丨丨丨	目于一丨丨丨
辱	辰寸一丨丶丶	辰寸一丨丶丶
匹	匚儿丿ㄋㄋㄋ	匚儿丿ㄋㄋㄋ
俱	亻目丿丶丶丶	亻目丿丶丶丶
辨	辛刂丶一丶丿	辛刂丶一丶丿
饿	食我丿一丨一	食我丿一丨一
蜂	虫文一一一丨	虫文一一一丨
哦	口我丿一丨一	口我丿一丨一
腔	月穴一丨一一	月穴一丨一一
郁	石月ㄋ丨丨丨	石月ㄋ丨丨丨
溃	氵丨ㄋ丿丶	氵丨ㄋ丿丶
糟	米笔丨ㄋ一丨	米笔丨ㄋ一丨
谨	讠堇一丨丨一	讠堇一丨丨一
葛	艹日丿ㄋ丿丶	艹日丿ㄋ丿丶
苗	艹田丨ㄋ一丨	艹田丨ㄋ一丨
肠	月㇉丿丿丿丿	月Z丿丿丿丿
忌	巴心丶ㄋ丶丶	巴心丶ㄋ丶丶
溜	氵留丨ㄋ一丨	氵留丨ㄋ一丨
鸿	氵工丿ㄋ丶ㄋ	氵工丿ㄋ丶ㄋ
爵	爪四ㄋ一一ㄋ	爪四ㄋ一一ㄋ
鹏	月月丿ㄋ丶ㄋ	月月丿ㄋ丶ㄋ
鹰	广亻丿丨丶一	广亻丿丨丶一
笼	龙一丿ㄋ丿	龙一丿ㄋ丿
丘	丘丿丨一丨一	丘丿丨一丨一
桂	木圭一丨一一	木圭一丨一一
滋	氵䒑ㄋㄋ丶ㄋ	氵首ㄋㄋ丶ㄋ
聊	耳留丿ㄋ丿ㄋ	耳留丿ㄋ丿ㄋ
挡	扌ㄋ一一一	扌ㄋ一一一
纲	纟冂丿丶丶丶	纟冂丿丶丶丶
肌	月几丿ㄋㄋㄋ	月几丿ㄋㄋㄋ
茨	艹次丶一丿ㄋ	艹次丶一丿ㄋ
壳	几丿ㄋㄋㄋ	几丿ㄋㄋㄋ
痕	疒艮ㄋ一一ㄋ	疒艮ㄋ一一ㄋ
碗	石宀丿ㄋ丶ㄋ	石宀丿ㄋ丶ㄋ
穴	穴丶丶ㄋ丿丶	穴丶丶ㄋ丿丶
膀	月立丶一ㄋ丿	月立丶一ㄋ丿
卓	卜日一丨丨丨	卜日一丨丨丨
贤	贝丨ㄋ丿丶	贝丨ㄋ丿丶
卧	臣卜丨丶丶丶	臣卜丨丶丶丶
膜	月莫一丨丨丨	月莫一丨丨丨
毅	立豕丿ㄋㄋ丶	立豕丿ㄋㄋ丶
锦	金白丨ㄋ丨丨	金白丨ㄋ丨丨
欠	欠丿ㄋ丿丶丶	欠丿ㄋ丿丶丶
哩	口田丨ㄋ一一	口田丨ㄋ一一
函	了水ㄋ丨丨丨	了水ㄋ丨丨丨
茫	落亡丶一ㄋㄋ	落亡丶一ㄋㄋ
昂	日留ㄋ丨丨丨	日留ㄋ丨丨丨
薛	艹笔丨ㄋ一ㄋ	艹笔丨ㄋ一ㄋ
皱	刍皮ㄋ丿丨ㄋ	刍皮ㄋ丿丨ㄋ
夸	大二ㄋㄋㄋㄋ	大二ㄋㄋㄋㄋ
豫	矛象丿ㄋ丨ㄋ	矛象丿ㄋ丨ㄋ
胃	田月丨ㄋ一一	田月丨ㄋ一一
舌	舌丿一丨丨ㄋ	舌丿一丨丨ㄋ
剥	尹水丨丨丨丨	尹水丨丨丨丨
傲	亻敖一一丨一	亻敖一一丨一
拾	扌合丿丶一丨	扌合丿丶一丨
窝	穴口丨ㄋ丿丶	穴口丨ㄋ丿丶
睁	目争丿ㄋㄋ一	目争丿ㄋㄋ一
携	扌隹ㄋ丿丿丿	扌隹ㄋ丿丿丿
陵	耳土丿丶丿ㄋ	耳土丿丶丿ㄋ
哼	口ㄋ丨丨丨	口ㄋ丨丨丨
棉	木白丨ㄋ丨丨	木白丨ㄋ丨丨
晴	日青一一丨一	日青一一丨一
铃	金令丿丶丶ㄋ	金令丿丶丶ㄋ
填	土直丿丶丶丶	土直丿丶丶丶
饲	食㇉一丨ㄋ一	食Z一丨ㄋ一
吻	口勿丿ㄋ丿丿	口勿丿ㄋ丿丿
渴	氵勹丿丶ㄋㄋ	氵勹丿丶ㄋㄋ
扮	扌分丿丶ㄋ丿	扌分丿丶ㄋ丿
逆	屰辶丶ㄋ丶丶	屰辶丶ㄋ丶丶
脆	月厃ㄋㄋㄋㄋ	月厃ㄋㄋㄋㄋ
喘	口山一丿丨ㄋ	口山一丿丨ㄋ
罩	四卜丨ㄋ一一	四卜丨ㄋ一一
卜	卜丨丶丶丶丶	卜丨丶丶丶丶
炉	火户丶ㄋ一丿	火户丶ㄋ一丿
柴	此木一丨丿丶	此木一丨丿丶
愉	忄亼丨ㄋ一一	忄亼丨ㄋ一一
绳	纟口丨ㄋ一一	纟口丨ㄋ一一
胎	月厶丨ㄋ一一	月厶丨ㄋ一一
蓄	艹亠ㄋㄋ丶丶	艹亠ㄋㄋ丶丶
眠	目民ㄋ一ㄋ一	目民ㄋ一ㄋ一
竭	立日丿ㄋ丿丶	立日丿ㄋ丿丶
喂	口田一ㄋ丿丶	口田一ㄋ丿丶
傻	亻丿丶一丿	亻丿丶一丿
慕	莫小丨丶丶丶	莫小丨丶丶丶
浑	氵冖一ㄋ一丨	氵冖一ㄋ一丨
奸	女舌一一丨丨	女舌一一丨丨
扇	户羽ㄋ丶一ㄋ	户羽ㄋ丶一ㄋ
柜	木匚ㄋ一一一	木匚ㄋ一一一
悦	忄𠮦丿ㄋㄋㄋ	忄兑丿ㄋㄋㄋ
拦	扌䒑一一一一	扌首一一一一
诞	讠笔丨一丨一	讠笔丨一丨一
饱	食勹ㄋ一ㄋㄋ	食勹ㄋ一ㄋㄋ
乾	ㄋㄋㄋㄋ	ㄋㄋㄋㄋ
泡	氵勹ㄋ一ㄋㄋ	氵勹ㄋ一ㄋㄋ
贼	贝戋一丿丿丿	贝戋一丿丿丿
亭	于一丨丨丨	于一丨丨丨
夕	歹丿ㄋ丶丶丶	歹丿ㄋ丶丶丶
爹	父歹丿ㄋ丶丶	父歹丿ㄋ丶丶
酬	西川丶丶丶丶	西川丶丶丶丶
儒	亻一丿丨ㄋ	亻一丿丨ㄋ
姻	女因丨ㄋ一丿	女因丨ㄋ一丿
卵	留笔丿ㄋ丨丶	留笔丿ㄋ丨丶
氛	气分丿丶ㄋ丿	气分丿丶ㄋ丿
泄	氵甘ㄋㄋㄋㄋ	氵甘ㄋㄋㄋㄋ
杆	木舌一一丨丨	木舌一一丨丨
挨	扌厶丿一一丿	扌厶丿一一丿
僧	亻曾丶丿丨ㄋ	亻曾丶丿丨ㄋ
蜜	宀心丿丨ㄋ一	宀心丿丨ㄋ一
吟	口令丿丶丶ㄋ	口令丿丶丶ㄋ
猩	犬日丿一一丨	犬日丿一一丨
遂	冫豕丶ㄋ丶丶	冫豕丶ㄋ丶丶
狭	犬夹丿丶丶丶	犬夹丿丶丶丶
肖	月丨ㄋ一一	月丨ㄋ一一
甜	舌甘一丨丨一	舌甘一丨丨一
霞	叚ㄋ一丨一	叚ㄋ一丨一
驳	马乂丿丶丶丶	马乂丿丶丶丶
裕	衤八丿丶丨ㄋ	衤八丿丶丨ㄋ
顽	元页一丿丨ㄋ	元页一丿丨ㄋ
於	方人丶丶丶丶	方人丶丶丶丶
摘	扌立丨ㄋ一丨	扌立丨ㄋ一丨
矮	矢禾ㄋ丿一一	矢禾ㄋ丿一一
秒	禾少丨丿丶丿	禾少丨丿丶丿
卿	留笔ㄋ一一ㄋ	留笔ㄋ一一ㄋ
畜	亠幺丨ㄋ一丨	亠幺丨ㄋ一丨
咽	口因丨ㄋ一丿	口因丨ㄋ一丿
披	扌皮ㄋ丿丨ㄋ	扌皮ㄋ丿丨ㄋ
辅	车甫一丨ㄋ一	车甫一丨ㄋ一
勾	勹厶ㄋ丶丶丶	勹厶ㄋ丶丶丶
盆	分四丨ㄋ丨丨	分四丨ㄋ丨丨
疆	弓土一丨ㄋ一	弓土一丨ㄋ一
赌	贝者一丨一丿	贝者一丨一丿
塑	屰月一丨一一	屰月一丨一一
畏	田笔ㄋ丿丶丶	田笔ㄋ丿丶丶
吵	口少丨丿丶丿	口少丨丿丶丿
囊	吅一一丨丨	吅一一丨丨
嗯	口因丶ㄋ丶丶	口因丶ㄋ丶丶
泊	氵白丿丨ㄋ一	氵白丿丨ㄋ一
肺	月笔丨ㄋ丨丨	月笔丨ㄋ丨丨
骤	马耳ㄋ丶丿丨	马耳ㄋ丶丿丨
缠	纟广丨ㄋ一一	纟广丨ㄋ一一
羞	羊丑ㄋ丨一一	羊丑ㄋ丨一一
冈	冂乂丿丶丶丶	冂乂丿丶丶丶
瞪	目一丨ㄋ一	目祭一丨ㄋ一
吊	口巾丨ㄋ丨丨	口巾丨ㄋ丨丨
贾	西贝丨ㄋ丿丶	西贝丨ㄋ丿丶
漏	氵尸一丨ㄋ丨	氵尸一丨ㄋ丨
斑	王文一一丨一	王文一一丨一
涛	氵丰一丨丶丶	氵丰一丨丶丶
悠	亻文丶ㄋ丶丶	亻文丶ㄋ丶丶
鹿	鹿丶一丿ㄋ丨	鹿丶一丿ㄋ丨
俘	亻爪ㄋ丨一一	亻爪ㄋ丨一一
锡	金日丿ㄋ丿丿	金日丿ㄋ丿丿
卑	卑丿丨ㄋ一一	卑丿丨ㄋ一一
葬	艹歹丿ㄋ一丿	艹歹丿ㄋ一丿
铭	金歹丨ㄋ一一	金歹丨ㄋ一一
滩	氵双丿丨丶一	氵双丿丨丶一
嫁	女宀一丿ㄋ丿	女宀一丿ㄋ丿
催	亻山丿丨丶一	亻山丿丨丶一
璇	王族ㄋ丨一丿	王族ㄋ丨一丿
翅	十双ㄋ丶一ㄋ	十双ㄋ丶一ㄋ
盒	合四丨ㄋ丨丨	合四丨ㄋ丨丨
蛮	亦虫丨ㄋ一丨	亦虫丨ㄋ一丨
矣	厶矢丿一一丿	厶矢丿一一丿
潘	氵釆丨ㄋ一丨	氵釆丨ㄋ一丨
歧	止十ㄋ丶丶丶	止十ㄋ丶丶丶
赐	贝日丿ㄋ丿丿	贝日丿ㄋ丿丿
锅	金口丨ㄋ丿丶	金口丨ㄋ丿丶
鲍	鱼勹ㄋ一ㄋㄋ	鱼勹ㄋ一ㄋㄋ
廊	广笔ㄋ一一ㄋ	广笔ㄋ一一ㄋ
拆	折笔丶丶丶丶	折笔丶丶丶丶
灌	氵艹丨ㄋ一丨	氵艹丨ㄋ一丨
勉	象儿ㄋ丿丿丿	象儿ㄋ丿丿丿
盲	亡目丨ㄋ一一	亡目丨ㄋ一一
宰	宀辛丶一丶丿	宀辛丶一丶丿
佐	亻石一丨一一	亻石一丨一一
啥	口亼一丨丨ㄋ	口亼一丨丨ㄋ
胀	月长丿一ㄋ丶	月长丿一ㄋ丶
扯	扌止丨一丨一	扌止丨一丨一
禧	衤壴丨ㄋ一一	衤壴丨ㄋ一一
辽	了辶丶ㄋ丶丶	了辶丶ㄋ丶丶
抹	扌未丨丿丶丶	扌未丨丿丶丶
筒	冂一丨ㄋ一	冂一丨ㄋ一
棋	木其一丨丨一	木其一丨丨一
裤	衤广一ㄋ一丨	衤广一ㄋ一丨
唉	口厶丿一一丿	口厶丿一一丿
朴	木卜丨丶丶丶	木卜丨丶丶丶
咐	口亻一丨丶丶	口亻一丨丶丶
孕	乃子ㄋ丨一一	乃子ㄋ丨一一
誓	折讠丶一一一	折讠丶一一一
喉	口亻ㄋ一丿一	口亻ㄋ一丿一
妄	亡女ㄋ丿一一	亡女ㄋ丿一一
拘	扌勹丨ㄋ一一	扌勹丨ㄋ一一
链	金车丶ㄋ丶丶	金车丶ㄋ丶丶
驰	马也ㄋ丨ㄋㄋ	马也ㄋ丨ㄋㄋ
栏	木䒑一一一一	木首一一一一
逝	折辶丶ㄋ丶丶	折辶丶ㄋ丶丶
窃	穴七ㄋ丿丿丿	穴七ㄋ丿丿丿
艳	丰鱼ㄋ丨一ㄋ	丰鱼ㄋ丨一ㄋ
臭	自犬一丿丶丶	自犬一丿丶丶
纤	纟舌丿一丨丨	纟舌丿一丨丨
玑	王几丿ㄋㄋㄋ	王几丿ㄋㄋㄋ
棵	木日一丨丿丶	木日一丨丿丶
趁	走人丿丿丿丿	走人丿丿丿丿
盈	乃双丨ㄋ丨丨	乃双丨ㄋ丨丨
匠	匚丘丿丿一丨	匚丘丿丿一丨
翁	公羽ㄋ丶一ㄋ	公羽ㄋ丶一ㄋ
愁	禾火丶ㄋ丶丶	禾火丶ㄋ丶丶
瞬	目丿ㄋ丶一	目丿ㄋ丶一
婴	贝贝ㄋ丿一一	贝贝ㄋ丿一一
孝	者子ㄋ丨一一	者子ㄋ丨一一
颈	轻页一丿丨ㄋ	轻页一丿丨ㄋ
倘	亻丨ㄋ丨ㄋ	亻丨ㄋ丨ㄋ
浙	氵折一丨一丿	氵折一丨一丿
谅	讠京丶一丨ㄋ	讠京丶一丨ㄋ
蔽	艹米丿一丿丶	艹米丿一丿丶
畅	日笔ㄋ丿丿丿	日笔ㄋ丿丿丿
赠	贝曾丶丿丨ㄋ	贝曾丶丿丨ㄋ
妮	女尸丿ㄋㄋㄋ	女尸丿ㄋㄋㄋ
莎	落少丨丿丶丿	落少丨丿丶丿
尉	尸示一丨丶丶	尸示一丨丶丶
冻	冫车丨丿丶丶	冫车丨丿丶丶
跪	厃ㄋㄋㄋㄋ	厃ㄋㄋㄋㄋ
闯	门马ㄋㄋ一一	门马ㄋㄋ一一
葡	芍甫一丨ㄋ一	芍甫一丨ㄋ一
後	彳幺丿丶丿ㄋ	彳幺丿丶丿ㄋ
厨	广豆一丨丶丶	广豆一丨丶丶
鸭	甲鸟丿ㄋ丶ㄋ	甲鸟丿ㄋ丶ㄋ
颠	直八一丿丨ㄋ	直八一丿丨ㄋ
遮	度水丶ㄋ丶丶	度水丶ㄋ丶丶
谊	讠宀丨ㄋ一一	讠宀丨ㄋ一一
圳	土川丿丨丨丨	土川丿丨丨丨
吁	口于一一丨丨	口于一一丨丨
仑	仑丿丶丿ㄋㄋ	仑丿丶丿ㄋㄋ
辟	辟ㄋ一丿丨ㄋ	辟ㄋ一丿丨ㄋ
瘤	疒留丨ㄋ一丨	疒留丨ㄋ一丨
嫂	女鼠丨ㄋ丶丶	女鼠丨ㄋ丶丶
陀	耳宀丿ㄋㄋㄋ	耳宀丿ㄋㄋㄋ
框	木匚一一丨一	木匚一一丨一
谭	讠西丨ㄋ一一	讠西丨ㄋ一一
亨	了ㄋ丨丨丨	了ㄋ丨丨丨
钦	金欠丿ㄋ丿丶	金欠丿ㄋ丿丶
庸	广聿丿ㄋ一一	广聿丿ㄋ一一
歉	兼欠丿ㄋ丿丶	兼欠丿ㄋ丿丶
芝	艹之丶ㄋ丶丶	艹之丶ㄋ丶丶
吼	口子ㄋㄋㄋㄋ	口子ㄋㄋㄋㄋ
甫	甫一丨ㄋ一一	甫一丨ㄋ一一
衫	衤川丿丿丿丿	衤川丿丿丿丿
宴	宀日ㄋ丿一一	宀日ㄋ丿一一
摊	扌双丿丨丶一	扌双丿丨丶一
嘱	口尸丿丨ㄋ一	口尸丿丨ㄋ一
衷	亠中丿ㄋ丿丶	亠中丿ㄋ丿丶
娇	女天丿丨丨丨	女天丿丨丨丨
陕	耳夹丿丶丶丶	耳夹丿丶丶丶
矩	矢匚ㄋ一一一	矢匚ㄋ一一一
浦	氵甫一丨ㄋ一	氵甫一丨ㄋ一
讶	讠牙一ㄋ丨丿	讠牙一ㄋ丨丿
耸	从耳一丨丨一	从耳一丨丨一
裸	衤日一丨丿丶	衤日一丨丿丶
碧	王白一丿丨ㄋ	王白一丿丨ㄋ
摧	扌山丿丨丶一	扌山丿丨丶一
薪	艹立一丨丿丶	艹立一丨丿丶
淋	氵林一丨丿丶	氵林一丨丿丶
耻	耳止丨一丨一	耳止丨一丨一
胶	月六丿丶丶丶	月六丿丶丶丶
屠	尸者一丨一丿	尸者一丨一丿
鹅	我鸟丿ㄋ丶ㄋ	我鸟丿ㄋ丶ㄋ
盼	目分丿丶ㄋ丿	目分丿丶ㄋ丿
饥	食几丿ㄋㄋㄋ	食几丿ㄋㄋㄋ
脖	月ㄋ丨一一	月ㄋ丨一一
虹	虫工一丨一一	虫工一丨一一
翠	羽亠丿丶丿丶	羽亠丿丶丿丶
崩	山月丿ㄋ一一	山月丿ㄋ一一
账	贝长丿一ㄋ丶	贝长丿一ㄋ丶
萍	落平一丶丿一	落平一丶丿一
逢	文丰丶ㄋ丶丶	文丰丶ㄋ丶丶
赚	贝兼丶丿一ㄋ	贝兼丶丿一ㄋ
撑	扌丿一一丨	扌丿一一丨
翔	羊羽ㄋ丶一ㄋ	羊羽ㄋ丶一ㄋ
绵	纟白丨ㄋ丨丨	纟白丨ㄋ丨丨
倡	亻日丨ㄋ一一	亻日丨ㄋ一一
枯	木古一丨丨ㄋ	木古一丨丨ㄋ
猴	犬亻ㄋ一丿一	犬亻ㄋ一丿一
巫	工从丿丶丿丶	工从丿丶丿丶
昭	日刀丨ㄋ一一	日刀丨ㄋ一一
怔	忄正一丨一丨	忄正一丨一丨
渊	氵刂丶丿一丨	氵刂丶丿一丨
凑	冫丿一丿丶	冫丿一丿丶
溪	氵爪ㄋㄋ丶一	氵爪ㄋㄋ丶一
蠢	日丨ㄋ一丨	日丨ㄋ一丨
禅	衤单丶丿丨ㄋ	衤单丶丿丨ㄋ
阐	门单丶丿丨ㄋ	门单丶丿丨ㄋ
旺	日王一一丨一	日王一一丨一
寓	宀日丨ㄋ丨一	宀日丨ㄋ丨一
藤	艹月丶丿一一	艹月丶丿一一
匪	匚非丨一一一	匚非丨一一一
伞	人冫一丨丨丨	人冫一丨丨丨
碑	石卑丿丨ㄋ一	石卑丿丨ㄋ一
挪	扌刀ㄋ丨丨丨	扌刀ㄋ丨丨丨
琼	王京丶一丨ㄋ	王京丶一丨ㄋ
脂	月七丨ㄋ一一	月七丨ㄋ一一
谎	讠艹丶一ㄋ丿	讠艹丶一ㄋ丿
慨	忄一ㄋ丿ㄋ	忄一ㄋ丿ㄋ
菩	艹立丨ㄋ一一	艹立丨ㄋ一一
萄	芍缶丿一一丨	芍缶丿一一丨
狮	犬刂一丨ㄋ丨	犬刂一丨ㄋ丨
掘	扌尸ㄋ丨丨ㄋ	扌尸ㄋ丨丨ㄋ
抄	扌少丨丿丶丿	扌少丨丿丶丿
岭	山令丿丶丶ㄋ	山令丿丶丶ㄋ
晕	日冖一ㄋ一丨	日冖一ㄋ一丨
砍	石欠丿ㄋ丿丶	石欠丿ㄋ丿丶
逮	尹水丶ㄋ丶丶	尹水丶ㄋ丶丶
掏	扌勹丿一一丨	扌勹丿一一丨
狄	犬火丶丿丿丶	犬火丶丿丿丶
晰	日木丿丿一丨	日木丿丿一丨
罕	冖八一一丨丨	冖八一一丨丨
挽	扌象丿ㄋㄋㄋ	扌象丿ㄋㄋㄋ
脾	月卑丿丨ㄋ一	月卑丿丨ㄋ一
舟	舟丿丿ㄋ丶一	舟丿丿ㄋ丶一
痴	疒矢丨ㄋ一一	疒矢丨ㄋ一一
蔡	艹一一丨丿	艹祭一一丨丿
剪	前刀ㄋ丿丿丿	前刀ㄋ丿丿丿
脊	水人丨ㄋ一一	水人丨ㄋ一一
弓	弓ㄋ一ㄋㄋㄋ	弓ㄋ一ㄋㄋㄋ
懒	忄束丿ㄋ丨ㄋ	忄束丿ㄋ丨ㄋ
叉	双笔丶丶丶丶	双笔丶丶丶丶
喃	口十丨ㄋ丶丿	口十丨ㄋ丶丿
拐	扌口ㄋ丿丿丿	扌口ㄋ丿丿丿
僚	亻大丶丶丨ㄋ	亻大丶丶丨ㄋ
捐	扌口丨ㄋ一一	扌口丨ㄋ一一
姊	女弓丶丿ㄋ一	女弓丶丿ㄋ一
骚	马双丶丨ㄋ一	马双丶丨ㄋ一
拓	扌石一丿丨ㄋ	扌石一丿丨ㄋ
歪	不正一丨一丨	不正一丨一丨
粘	米占丨一丨ㄋ	米占丨一丨ㄋ
柄	木丙丿丶丶丶	木丙丿丶丶丶
坑	土亠丿ㄋㄋㄋ	土亠丿ㄋㄋㄋ
陌	耳笔丿丨ㄋ一	耳笔丿丨ㄋ一
窄	穴乍丿一丨一	穴乍丿一丨一
湘	氵相一丨丿丶	氵相一丨丿丶
兆	儿水丶一丿丶	儿水丶一丿丶
崖	山广一丨一一	山广一丨一一
骄	马天丿丨丨丨	马天丿丨丨丨
刹	乂木丨丨丨丨	乂木丨丨丨丨
鞭	革亻一丨ㄋ一	革亻一丨ㄋ一
芒	艹亡丶一ㄋㄋ	艹亡丶一ㄋㄋ
筋	月ㄋ丿丿丿	月ㄋ丿丿丿
聘	耳甲一ㄋㄋㄋ	耳甲一ㄋㄋㄋ
棍	木日一ㄋ丿ㄋ	木日一ㄋ丿ㄋ
钩	金勹ㄋ丶丶丶	金勹ㄋ丶丶丶
嚷	口亠丨ㄋ一丨	口亠丨ㄋ一丨
腺	月白丨ㄋ丿丶	月白丨ㄋ丿丶
弦	弓亠ㄋㄋ丶丶	弓亠ㄋㄋ丶丶
焰	火鱼丿丨一ㄋ	火鱼丿丨一ㄋ
耍	而女ㄋ丿一一	而女ㄋ丿一一
俯	亻广丿丶一丨	亻广丿丶一丨
厘	广田丨ㄋ一一	广田丨ㄋ一一
愣	忄四丶一ㄋ丿	忄四丶一ㄋ丿
厦	广石丨ㄋ一一	广石丨ㄋ一一
恳	艮心丶ㄋ丶丶	艮心丶ㄋ丶丶
饶	食尧一ㄋ丿一	食尧一ㄋ丿一
钉	金于一丨丨丨	金于一丨丨丨
寡	宀石丨ㄋ一一	宀石丨ㄋ一一
憾	忄戊一丨ㄋ一	忄戊一丨ㄋ一
摔	扌亠ㄋㄋ丶丶	扌亠ㄋㄋ丶丶
叠	双双丶ㄋ丨ㄋ	双双丶ㄋ丨ㄋ
惹	艹石丨ㄋ一丶	艹石丨ㄋ一丶
喻	口亼丨ㄋ一一	口亼丨ㄋ一一
谱	讠䒑丨丨丶丿	讠首丨丨丶丿
愧	忄鬼丿丨ㄋ一	忄鬼丿丨ㄋ一
煌	火白一一丨一	火白一一丨一
徽	糸ㄋㄋ丶丨	糸ㄋㄋ丶丨
溶	氵穴丿丶丨ㄋ	氵穴丿丶丨ㄋ
坠	耳人一丨一一	耳人一丨一一
煞	刍文丶丶丶丶	刍文丶丶丶丶
巾	巾丨ㄋ丨丨丨	巾丨ㄋ丨丨丨
滥	氵丨ㄋ丨丨	氵丨ㄋ丨丨
洒	氵西一丨ㄋ丿	氵西一丨ㄋ丿
堵	土者一丨一丿	土者一丨一丿
瓷	次瓦一ㄋㄋ丶	次瓦一ㄋㄋ丶
咒	吅几丿ㄋㄋㄋ	吅几丿ㄋㄋㄋ
姨	女大ㄋ一ㄋㄋ	女大ㄋ一ㄋㄋ
棒	木一一丨丨	木一一丨丨
郡	尹口ㄋ丨丨丨	尹口ㄋ丨丨丨
浴	氵八丿丶丨ㄋ	氵八丿丶丨ㄋ
媚	女尸丨ㄋ一一	女尸丨ㄋ一一
稣	鱼禾一丨丿丶	鱼禾一丨丿丶
淮	氵隹丿丨丶一	氵隹丿丨丶一
哎	口艹丿丶丶丶	口艹丿丶丶丶
屁	尸比一ㄋ丿ㄋ	尸比一ㄋ丿ㄋ
漆	氵木丿丶丶丶	氵木丿丶丶丶
淫	氵爪丿一丨一	氵爪丿一丨一
巢	川日一丨丿丶	川日一丨丿丶
吩	口分丿丶ㄋ丿	口分丿丶ㄋ丿
撰	扌巴ㄋ一ㄋ一	扌巴ㄋ一ㄋ一
啸	口聿丿丶丿丨	口聿丿丶丿丨
滞	氵艹丶ㄋ丨ㄋ	氵艹丶ㄋ丨ㄋ
玫	王文丿一丿丶	王文丿一丿丶
硕	石页一丿丨ㄋ	石页一丿丨ㄋ
钓	金勹丶丶丶丶	金勹丶丶丶丶
蝶	虫甘ㄋ一丨丿	虫甘ㄋ一丨丿
膝	月木丿丶丨丶	月木丿丶丨丶
姚	女儿丶一丿丶	女儿丶一丿丶
茂	艹戊一丿ㄋ丿	艹戊一丿ㄋ丿
躯	身匚丿丶丶丶	身匚丿丶丶丶
吏	鬲乂丿丶丶丶	鬲乂丿丶丶丶
猿	犬吉丿ㄋ丿丶	犬吉丿ㄋ丿丶
寨	寒木一丨丿丶	寒木一丨丿丶
恕	女口丶ㄋ丶丶	女口丶ㄋ丶丶
渠	氵匚ㄋ一一丨	氵匚ㄋ一一丨
戚	戊上丨丿丶丶	戊上丨丿丶丶
辰	辰一丿一一ㄋ	辰一丿一一ㄋ
舶	舟白丿丨ㄋ一	舟白丿丨ㄋ一
颁	分页一丿丨ㄋ	分页一丿丨ㄋ
惶	忄白一一丨一	忄白一一丨一
狐	犬爪丿丿ㄋ丶	犬爪丿丿ㄋ丶
讽	讠几丿丶丶丶	讠几丿丶丶丶
笨	木一一一一	木一一一一
袍	衤勹ㄋ一ㄋㄋ	衤勹ㄋ一ㄋㄋ
嘲	口丿ㄋ一一	口丿ㄋ一一
啡	口非丨一一一	口非丨一一一
泼	氵发ㄋ丿ㄋ丶	氵发ㄋ丿ㄋ丶
衔	彳金一一丨丨	彳金一一丨丨
倦	亻ㄋㄋㄋㄋ	亻ㄋㄋㄋㄋ
涵	氵了丶一丿丶	氵了丶一丿丶
雀	小隹丿丨丶一	小隹丿丨丶一
旬	勹日丨ㄋ一一	勹日丨ㄋ一一
僵	亻笔丨ㄋ一丨	亻笔丨ㄋ一丨
撕	扌其丿丿一丨	扌其丿丿一丨
肢	月十ㄋ丶丶丶	月十ㄋ丶丶丶
垄	龙土一丨一一	龙土一丨一一
逸	象儿丶丶ㄋ丶	象儿丶丶ㄋ丶
夷	大弓ㄋ一ㄋㄋ	大弓ㄋ一ㄋㄋ
茅	艹矛ㄋ丶ㄋ丨	艹矛ㄋ丶ㄋ丨
侨	亻天丿丨丨丨	亻天丿丨丨丨
舆	鼠车一丿丶丶	鼠车一丿丶丶
窑	穴缶丿一一丨	穴缶丿一一丨
涅	氵日一丨一一	氵日一丨一一
蒲	落甫一丨ㄋ一	落甫一丨ㄋ一
谦	讠兼丶丿一ㄋ	讠兼丶丿一ㄋ
杭	木亠丿ㄋㄋㄋ	木亠丿ㄋㄋㄋ
噢	口丶丿一丨	口丶丿一丨
弊	米文一丿丨丨	米文一丿丨丨
勋	口贝ㄋ丿丿丿	口贝ㄋ丿丿丿
刮	舌刂丨丨丨丨	舌刂丨丨丨丨
郊	六乂ㄋ丨丨丨	六乂ㄋ丨丨丨
凄	冫笔ㄋ一一丨	冫笔ㄋ一一丨
捧	扌一一丨丨	扌一一丨丨
浸	氵尹丶ㄋㄋ丶	氵尹丶ㄋㄋ丶
砖	石二ㄋ丶丶丶	石二ㄋ丶丶丶
鼎	目片丨一丨ㄋ	目片丨一丨ㄋ
篮	丨ㄋ丨丨	丨ㄋ丨丨
蒸	艹了ㄋ丿丶一	艹了ㄋ丿丶一
饼	食䒑一丿丨丨	食首一丿丨丨
亩	亠田丨ㄋ一丨	亠田丨ㄋ一丨
肾	月丨ㄋ一一	月丨ㄋ一一
陡	耳走一丨一丨	耳走一丨一丨
爪	爪丿丿丨丶丶	爪丿丿丨丶丶
兔	象儿丶丶丶丶	象儿丶丶丶丶
殷	广尹ㄋ丿ㄋㄋ	广尹ㄋ丿ㄋㄋ
贞	卜贝丨ㄋ丿丶	卜贝丨ㄋ丿丶
哑	口亚一丨丨丶	口亚一丨丨丶
荐	艹ㄋ丨一一	艹ㄋ丨一一
炭	山石丶丿丿丶	山石丶丿丿丶
坟	土文丶一丿丶	土文丶一丿丶
眨	目笔丶ㄋ丶丶	目笔丶ㄋ丶丶
搏	扌甫一丨丶丶	扌甫一丨丶丶
咳	口亥丶一ㄋ丿	口亥丶一ㄋ丿
拢	扌龙一丿ㄋ丿	扌龙一丿ㄋ丿
舅	鼠田ㄋ丿丿丿	鼠田ㄋ丿丿丿
昧	日未丨丿丶丶	日未丨丿丶丶
擅	扌亠丨ㄋ丨ㄋ	扌亠丨ㄋ丨ㄋ
爽	大乂丿丶丿丶	大乂丿丶丿丶
咖	口加ㄋ丿丨ㄋ	口加ㄋ丿丨ㄋ
搁	扌门丿ㄋ丶丨	扌门丿ㄋ丶丨
禄	衤尹丨ㄋ丿丶	衤尹丨ㄋ丿丶
雌	此隹丿丨丶一	此隹丿丨丶一
哨	口丨ㄋ一一	口丨ㄋ一一
巩	工几丶丶丶丶	工几丶丶丶丶
绢	纟口丨ㄋ一一	纟口丨ㄋ一一
螺	虫田ㄋㄋ丶丨	虫田ㄋㄋ丶丨
裹	亠日一丨丿丶	亠日一丨丿丶
昔	共日丨ㄋ一一	共日丨ㄋ一一
轩	车舌一一丨丨	车舌一一丨丨
谬	讠羽丿丶丿丿	讠羽丿丶丿丿
谍	讠甘ㄋ一丨丿	讠甘ㄋ一丨丿
龟	鱼日ㄋㄋㄋㄋ	鱼日ㄋㄋㄋㄋ
媳	女自丶ㄋ丶丶	女自丶ㄋ丶丶
姜	羊女ㄋ丿一一	羊女ㄋ丿一一
瞎	目宀一一一丨	目宀一一一丨
冤	冖象丿ㄋ丶丶	冖象丿ㄋ丶丶
鸦	牙鸟丿ㄋ丶ㄋ	牙鸟丿ㄋ丶ㄋ
蓬	艹文一一一丨	艹文一一一丨
巷	共巴ㄋ一ㄋㄋ	共巴ㄋ一ㄋㄋ
琳	王林一丨丿丶	王林一丨丿丶
栽	木一丨丿丶	木一丨丿丶
沾	氵占丨一丨ㄋ	氵占丨一丨ㄋ
诈	讠乍丿一丨一	讠乍丿一丨一
斋	文而一丿丨ㄋ	文而一丿丨ㄋ
瞒	目艹一丨ㄋ丿	目艹一丨ㄋ丿
彪	虍几丿丿丿丿	虍几丿丿丿丿
厄	广巴ㄋㄋㄋㄋ	广巴ㄋㄋㄋㄋ
咨	次口丨ㄋ一一	次口丨ㄋ一一
纺	纟方丶一ㄋ丿	纟方丶一ㄋ丿
罐	缶艹丨ㄋ一丨	缶艹丨ㄋ一丨
桶	木甬ㄋ丶丨ㄋ	木甬ㄋ丶丨ㄋ
壤	土亠丨ㄋ一丨	土亠丨ㄋ一丨
糕	米羊丶丶丶丶	米羊丶丶丶丶
颂	公页一丿丨ㄋ	公页一丿丨ㄋ
膨	月壴丿丿丿丿	月壴丿丿丿丿
谐	讠比丿丨ㄋ一	讠比丿丨ㄋ一
垒	厶厶ㄋ丶一丨	厶厶ㄋ丶一丨
咕	口古一丨丨ㄋ	口古一丨丨ㄋ
隙	耳小丨ㄋ一一	耳小丨ㄋ一一
辣	辛束一丨ㄋ一	辛束一丨ㄋ一
绑	纟丰ㄋ丨丨丨	纟丰ㄋ丨丨丨
宠	宀龙一丿ㄋ丿	宀龙一丿ㄋ丿
嘿	口黑丨ㄋ丶丿	口黑丨ㄋ丶丿
兑	𠮦儿丿ㄋㄋㄋ	兑儿丿ㄋㄋㄋ
霉	ㄋㄋ丶一	ㄋㄋ丶一
挫	扌从一丨一一	扌从一丨一一
稽	禾尢丶丿ㄋ丨	禾尢丶丿ㄋ丨
辐	车鬲丨ㄋ一丨	车鬲丨ㄋ一丨
乞	乙ㄋㄋㄋㄋ	乙ㄋㄋㄋㄋ
纱	纟少丨丿丶丿	纟少丨丿丶丿
裙	衤尹丨ㄋ一一	衤尹丨ㄋ一一
嘻	口壴丨ㄋ一一	口壴丨ㄋ一一
哇	口圭一丨一一	口圭一丨一一
绣	纟禾ㄋ丿丿丿	纟禾ㄋ丿丿丿
杖	木石丶丶丶丶	木石丶丶丶丶
塘	土广ㄋ一一丨	土广ㄋ一一丨
衍	彳氵一一丨丨	彳氵一一丨丨
轴	车甲丨ㄋ一丨	车甲丨ㄋ一丨
攀	木乂丿丶一丨	木乂丿丶一丨
膊	月甫一丨丶丶	月甫一丨丶丶
譬	辟讠丶一一一	辟讠丶一一一
斌	文笔一ㄋ丶丨	文笔一ㄋ丶丨
祈	衤丘丿丿一丨	衤丘丿丿一丨
踢	日丿ㄋ丿丿	日丿ㄋ丿丿
肆	长聿ㄋ一一一	长聿ㄋ一一一
坎	土欠丿ㄋ丿丶	土欠丿ㄋ丿丶
轿	车天丿丨丨丨	车天丿丨丨丨
泣	氵立丶一丶丿	氵立丶一丶丿
棚	木月丿ㄋ一一	木月丿ㄋ一一
屡	尸米ㄋ丿一一	尸米ㄋ丿一一
躁	口丨ㄋ一丨	口丨ㄋ一丨
邱	丘耳ㄋ丨丨丨	丘耳ㄋ丨丨丨
凰	几白一一丨一	几白一一丨一
溢	氵䒑丿丶丨ㄋ	氵首丿丶丨ㄋ
椎	木隹丿丨丶一	木隹丿丨丶一
砸	石匚丨ㄋ丨丨	石匚丨ㄋ丨丨
趟	走丨ㄋ丨ㄋ	走丨ㄋ丨ㄋ
帘	穴巾丨ㄋ丨丨	穴巾丨ㄋ丨丨
帆	巾几丶丶丶丶	巾几丶丶丶丶
栖	木西一丨ㄋ丿	木西一丨ㄋ丿
窜	穴口丨ㄋ一丨	穴口丨ㄋ一丨
丸	九笔丶丶丶丶	九笔丶丶丶丶
斩	车丘丿丿一丨	车丘丿丿一丨
堤	土是丨ㄋ一一	土是丨ㄋ一一
塌	土日ㄋ丶一ㄋ	土日ㄋ丶一ㄋ
厢	广相一丨丿丶	广相一丨丿丶
贩	贝广ㄋ丶丶丶	贝广ㄋ丶丶丶
掀	折欠丿ㄋ丿丶	折欠丿ㄋ丿丶
喀	口宀丿ㄋ丶丶	口宀丿ㄋ丶丶
乖	舌北丨一一丿	舌北丨一一丿
谜	讠米丶ㄋ丶丶	讠米丶ㄋ丶丶
捏	扌日一丨一一	扌日一丨一一
阎	门鱼丿丨一ㄋ	门鱼丿丨一ㄋ
滨	氵宀丿丨一丨	氵宀丿丨一丨
虏	虍力ㄋ丿丿丿	虍力ㄋ丿丿丿
匙	是七丿ㄋㄋㄋ	是七丿ㄋㄋㄋ
芦	艹户丶ㄋ一丿	艹户丶ㄋ一丿
苹	艹平一丶丿一	艹平一丶丿一
卸	止ㄋ丨丨丨	止ㄋ丨丨丨
沼	氵刀丨ㄋ一一	氵刀丨ㄋ一一
钥	金月丿ㄋ一一	金月丿ㄋ一一
株	木笔丨丿丶丶	木笔丨丿丶丶
祷	衤丰一丨丶丶	衤丰一丨丶丶
剖	立口丨丨丨丨	立口丨丨丨丨
熙	臣巴丶丶丶丶	臣巴丶丶丶丶
劈	辟刀ㄋ丿丿丿	辟刀ㄋ丿丿丿
怯	忄去一丨一ㄋ	忄去一丨一ㄋ
哗	口化一丨丨丨	口化一丨丨丨
棠	木一丨丿丶	木一丨丿丶
胳	月各丿ㄋ丶丨	月各丿ㄋ丶丨
桩	木广一丨一一	木广一丨一一
瑰	王鬼丿丨ㄋ一	王鬼丿丨ㄋ一
娱	女口一一丿丶	女口一一丿丶
娶	耳双ㄋ丿一一	耳双ㄋ丿一一
沫	氵未丨丿丶丶	氵未丨丿丶丶
嗓	口双ㄋ丶ㄋ丶	口双ㄋ丶ㄋ丶
蹲	酋一丨丶丶	酋一丨丶丶
焚	林火丶丿丿丶	林火丶丿丿丶
淘	氵勹丿一一丨	氵勹丿一一丨
嫩	女束丿一丿丶	女束丿一丿丶
韵	音勹丶一一一	音勹丶一一一
衬	衤寸一丨丶丶	衤寸一丨丶丶
匈	勹乂ㄋ丨丨丨	勹乂ㄋ丨丨丨
竖	立丶一丶丿	立丶一丶丿
钧	金勹丶一一一	金勹丶一一一
峻	山厶丿丶丿ㄋ	山厶丿丶丿ㄋ
豹	豸勹丶丶丶丶	豸勹丶丶丶丶
捞	扌萝ㄋ丿丿丿	扌萝ㄋ丿丿丿
菊	芍米丶丿一丨	芍米丶丿一丨
鄙	口十丨ㄋ丨ㄋ	口十丨ㄋ丨ㄋ
魄	白鬼丿丨ㄋ一	白鬼丿丨ㄋ一
兜	白留ㄋ一丿ㄋ	白留ㄋ一丿ㄋ
哄	口共一丨丨一	口共一丨丨一
颖	七禾一丿丨ㄋ	七禾一丿丨ㄋ
镑	金立丶一ㄋ丿	金立丶一ㄋ丿
屑	尸丨ㄋ一一	尸丨ㄋ一一
蚁	虫义丶丿丶丶	虫义丶丿丶丶
壶	业丨丨丶丿	业丨丨丶丿
怡	忄厶丨ㄋ一一	忄厶丨ㄋ一一
渗	氵厶丿丿丿丿	氵厶丿丿丿丿
秃	禾几丿ㄋㄋㄋ	禾几丿ㄋㄋㄋ
迦	加辶丶ㄋ丶丶	加辶丶ㄋ丶丶
旱	日舌一一丨丨	日舌一一丨丨
哟	口纟丿ㄋ丶丶	口纟丿ㄋ丶丶
咸	戊鬲一丨ㄋ一	戊鬲一丨ㄋ一
焉	正与丶丶丶丶	正与丶丶丶丶
宛	宀歹ㄋㄋㄋㄋ	宀歹ㄋㄋㄋㄋ
谴	讠丨ㄋ一ㄋ	讠丨ㄋ一ㄋ
稻	禾爪丿丨一ㄋ	禾爪丿丨一ㄋ
铸	金丰一丨丶丶	金丰一丨丶丶
伽	亻加ㄋ丿丨ㄋ	亻加ㄋ丿丨ㄋ
锻	金段丿丨一一	金段丿丨一一
詹	厃八丶一一一	厃八丶一一一
毙	比歹丿ㄋㄋㄋ	比歹丿ㄋㄋㄋ
恍	忄光丨丶丿一	忄光丨丶丿一
贬	贝笔丶ㄋ丶丶	贝笔丶ㄋ丶丶
烛	火虫丨ㄋ一丨	火虫丨ㄋ一丨
骇	马亥丶一ㄋ丿	马亥丶一ㄋ丿
芯	艹心丶ㄋ丶丶	艹心丶ㄋ丶丶
汁	氵十一丨丨丨	氵十一丨丨丨
桓	木笔丨ㄋ一一	木笔丨ㄋ一一
坊	土方丶一ㄋ丿	土方丶一ㄋ丿
驴	马户丶ㄋ一丿	马户丶ㄋ一丿
朽	木丂一ㄋㄋㄋ	木丂一ㄋㄋㄋ
靖	立青一一丨一	立青一一丨一
佣	亻甬丿ㄋ一一	亻甬丿ㄋ一一
汝	氵女ㄋ丿一一	氵女ㄋ丿一一
碌	石尹丨ㄋ丿丶	石尹丨ㄋ丿丶
迄	乙丶ㄋ丶丶	乙丶ㄋ丶丶
冀	北田一丨丨一	北田一丨丨一
荆	艹开丨丨丨丨	艹开丨丨丨丨
崔	山隹丿丨丶一	山隹丿丨丶一
雁	广亻丿丨丶一	广亻丿丨丶一
绅	纟日丨丨丨丨	纟日丨丨丨丨
珊	王冂丨ㄋ一一	王冂丨ㄋ一一
榜	木立丶一ㄋ丿	木立丶一ㄋ丿
诵	讠甬ㄋ丶丨ㄋ	讠甬ㄋ丶丨ㄋ
傍	亻立丶一ㄋ丿	亻立丶一ㄋ丿
彦	立广丿丿丿丿	立广丿丿丿丿
醇	西ㄋ丨一一	西ㄋ丨一一
笛	甲丨ㄋ一丨	甲丨ㄋ一丨
禽	人㐫丨ㄋㄋ丶	人离丨ㄋㄋ丶
勿	勿丿ㄋ丿丿丿	勿丿ㄋ丿丿丿
娟	女口丨ㄋ一一	女口丨ㄋ一一
瞄	目艹丨ㄋ一丨	目艹丨ㄋ一丨
幢	巾立丨ㄋ一一	巾立丨ㄋ一一
寇	宀元丨一ㄋ丶	宀元丨一ㄋ丶
睹	目者一丨一丿	目者一丨一丿
贿	贝石丨ㄋ一一	贝石丨ㄋ一一
踩	爪一丨丿丶	爪一丨丿丶
霆	王ㄋ丶丶丶	王ㄋ丶丶丶
呜	口勹ㄋ一一一	口勹ㄋ一一一
拱	扌共一丨丨一	扌共一丨丨一
妃	女巴ㄋ一ㄋㄋ	女巴ㄋ一ㄋㄋ
蔑	萝戊丶丶丶丶	萝戊丶丶丶丶
谕	讠亼丨ㄋ一一	讠亼丨ㄋ一一
缚	纟甫一丨丶丶	纟甫一丨丶丶
诡	讠厃ㄋㄋㄋㄋ	讠厃ㄋㄋㄋㄋ
篷	文一一一丨	文一一一丨
淹	氵大丨ㄋ一一	氵大丨ㄋ一一
腕	月宀丿ㄋ丶ㄋ	月宀丿ㄋ丶ㄋ
煮	者水丶丶丶丶	者水丶丶丶丶
倩	亻青一一丨一	亻青一一丨一
卒	亠从一丨丨丨	亠从一丨丨丨
勘	其乙ㄋ丿丿丿	其乙ㄋ丿丿丿
馨	土尸丿ㄋㄋ丶	土尸丿ㄋㄋ丶
逗	豆辶丶ㄋ丶丶	豆辶丶ㄋ丶丶
贱	贝戋一一ㄋ丿	贝戋一一ㄋ丿
甸	勹田丨ㄋ一丨	勹田丨ㄋ一丨
炒	火少丨丿丶丿	火少丨丿丶丿
灿	火山丨ㄋ丨丨	火山丨ㄋ丨丨
敞	冂丨ㄋ一丿	冂丨ㄋ一丿
蜡	虫共丨ㄋ一一	虫共丨ㄋ一一
囚	口人丿丶丶丶	口人丿丶丶丶
栗	西木一丨丿丶	西木一丨丿丶
辜	古辛丶一丶丿	古辛丶一丶丿
垫	执土一丨一一	执土一丨一一
妒	女户丶ㄋ一丿	女户丶ㄋ一丿
魁	鬼冫一丨丨丨	鬼冫一丨丨丨
谣	讠爪丿一一丨	讠爪丿一一丨
寞	宀莫一丨丨丨	宀莫一丨丨丨
甩	月乙ㄋㄋㄋㄋ	月乙ㄋㄋㄋㄋ
蜀	四勹丨ㄋ一丨	四勹丨ㄋ一丨
枕	木冖丿ㄋㄋㄋ	木冖丿ㄋㄋㄋ
涯	氵广一丨一一	氵广一丨一一
丐	笔卜ㄋㄋㄋㄋ	笔卜ㄋㄋㄋㄋ
泳	氵笔ㄋㄋ丿丶	氵笔ㄋㄋ丿丶
奎	大圭一丨一一	大圭一丨一一
泌	氵心丿丿丿丿	氵心丿丿丿丿
逾	亼月丨丨丶ㄋ	亼月丨丨丶ㄋ
叮	口于一丨丨丨	口于一丨丨丨
黛	代黑丨ㄋ丶丿	代黑丨ㄋ丶丿
燥	火口丨ㄋ一丨	火口丨ㄋ一丨
掷	扌䒑一丿丶ㄋ	扌首一丿丶ㄋ
藉	艹未一丨丨一	艹未一丨丨一
憎	忄曾丶丿丨ㄋ	忄曾丶丿丨ㄋ
枢	木区一丿丶ㄋ	木区一丿丶ㄋ
鲸	鱼京丶一丨ㄋ	鱼京丶一丨ㄋ
弘	弓厶ㄋ丶丶丶	弓厶ㄋ丶丶丶
倚	亻大一丨ㄋ一	亻大一丨ㄋ一
侮	亻ㄋㄋ丶一	亻ㄋㄋ丶一
藩	落釆丨ㄋ一丨	落釆丨ㄋ一丨
拂	扌弓丿丨丨丨	扌弓丿丨丨丨
鹤	冖隹丿ㄋ丶ㄋ	冖隹丿ㄋ丶ㄋ
蚀	食虫丨ㄋ一丨	食虫丨ㄋ一丨
芙	艹夫一一丿丶	艹夫一一丿丶
浆	北歹丨ㄋ丿丶	北歹丨ㄋ丿丶
垃	土立丶一丶丿	土立丶一丶丿
烤	火者一ㄋㄋㄋ	火者一ㄋㄋㄋ
晒	日西一丨ㄋ丿	日西一丨ㄋ丿
霜	相一丨丿丶	相一丨丿丶
剿	川日一丨丿丶	川日一丨丿丶
蕴	艹纟丨ㄋ一一	艹纟丨ㄋ一一
圾	土及丿ㄋ丶丶	土及丿ㄋ丶丶
绸	纟冂一丨一丨	纟冂一丨一丨
屿	山与一一一一	山与一一一一
氢	气轻ㄋ丶一丨	气轻ㄋ丶一丨
驼	马宀丿ㄋㄋㄋ	马宀丿ㄋㄋㄋ
妆	北女ㄋ丿一一	北女ㄋ丿一一
捆	扌口一丨丿丶	扌口一丨丿丶
铅	金几丨ㄋ一一	金几丨ㄋ一一
逛	犬王丶ㄋ丶丶	犬王丶ㄋ丶丶
淑	氵上丨丿丶ㄋ	氵上丨丿丶ㄋ
榴	木留丨ㄋ一丨	木留丨ㄋ一丨
痒	疒羊丶丿一一	疒羊丶丿一一
丙	丙人丿丶丶丶	丙人丿丶丶丶
钞	金少丨丿丶丿	金少丨丿丶丿
蹄	立丨ㄋ丨丨	立丨ㄋ丨丨
犬	犬一丿丶丶丶	犬一丿丶丶丶
躬	身弓ㄋ一ㄋㄋ	身弓ㄋ一ㄋㄋ
昼	尺旦丨ㄋ一一	尺旦丨ㄋ一一
藻	落口丨ㄋ一丨	落口丨ㄋ一丨
蛛	虫笔丨丿丶丶	虫笔丨丿丶丶
褐	衤日丿ㄋ丿丶	衤日丿ㄋ丿丶
颊	夹人一丿丨ㄋ	夹人一丿丨ㄋ
奠	酋大一丿丶丶	酋大一丿丶丶
募	莫力ㄋ丿丿丿	莫力ㄋ丿丿丿
耽	耳冖丿ㄋㄋㄋ	耳冖丿ㄋㄋㄋ
蹈	爪丿丨一ㄋ	爪丿丨一ㄋ
陋	耳丙丿丶ㄋㄋ	耳丙丿丶ㄋㄋ
侣	亻口丨ㄋ一一	亻口丨ㄋ一一
魅	鬼未丨丿丶丶	鬼未丨丿丶丶
岚	山几丿丶丶丶	山几丿丶丶丶
侄	亻至一ㄋ丶一	亻至一ㄋ丶一
虐	虍尹一ㄋ一一	虍尹一ㄋ一一
堕	耳石丿ㄋ一一	耳石丿ㄋ一一
陛	耳比一丨一一	耳比一丨一一
莹	萝王丶丶丶丶	萝王丶丶丶丶
荫	艹耳丿ㄋ一一	艹耳丿ㄋ一一
狡	犬六丿丶丶丶	犬六丿丶丶丶
阀	门亻一ㄋ丿丶	门亻一ㄋ丿丶
绞	纟六丿丶丶丶	纟六丿丶丶丶
膏	口丨ㄋ一一	口丨ㄋ一一
垮	土大一一ㄋㄋ	土大一一ㄋㄋ
茎	艹轻ㄋ丶一丨	艹轻ㄋ丶一丨
缅	纟面一丿丨ㄋ	纟面一丿丨ㄋ
喇	口束丨丨丨丨	口束丨丨丨丨
绒	纟戋一丿丿丿	纟戋一丿丿丿
搅	扌丨ㄋ丿ㄋ	扌丨ㄋ丿ㄋ
凳	豆丿ㄋㄋㄋ	祭豆丿ㄋㄋㄋ
梭	木厶丿丶丿ㄋ	木厶丿丶丿ㄋ
丫	冫笔丨丨丨丨	冫笔丨丨丨丨
姬	女臣一丨丨ㄋ	女臣一丨丨ㄋ
诏	讠刀丨ㄋ一一	讠刀丨ㄋ一一
钮	金丑ㄋ丨一一	金丑ㄋ丨一一
棺	木宀丨ㄋ一ㄋ	木宀丨ㄋ一ㄋ
耿	耳火丶丿丿丶	耳火丶丿丿丶
缔	纟立丨ㄋ丨丨	纟立丨ㄋ丨丨
懈	忄角ㄋ丿丿一	忄角ㄋ丿丿一
嫉	女疒丿一一丿	女疒丿一一丿
灶	火土一丨一一	火土一丨一一
匀	勹冫丶一一一	勹冫丶一一一
嗣	口ㄋ一丨ㄋ	口ㄋ一丨ㄋ
鸽	合鸟丿ㄋ丶ㄋ	合鸟丿ㄋ丶ㄋ
澡	氵口丨ㄋ一丨	氵口丨ㄋ一丨
凿	业羊ㄋ丨丨丨	业羊ㄋ丨丨丨
纬	纟韦一一ㄋ丨	纟韦一一ㄋ丨
沸	氵弓丿丨丨丨	氵弓丿丨丨丨
刃	刀笔丶丶丶丶	刀笔丶丶丶丶
畴	田丰一丨丶丶	田丰一丨丶丶
遏	日勹丿丶ㄋ丶	日勹丿丶ㄋ丶
烁	火留丨丿丶丶	火留丨丿丶丶
嗅	口自一丿丶丶	口自一丿丶丶
叭	口八丿丶丶丶	口八丿丶丶丶
熬	敖水丶丶丶丶	敖水丶丶丶丶
瞥	米文丨ㄋ一一	米文丨ㄋ一一
骸	骨亥丶一ㄋ丿	骨亥丶一ㄋ丿
奢	大者一丨一丿	大者一丨一丿
拙	扌山ㄋ丨丨丨	扌山ㄋ丨丨丨
栋	木车丨丿丶丶	木车丨丿丶丶
毯	毛火丶丿丿丶	毛火丶丿丿丶
桐	木冂一丨ㄋ一	木冂一丨ㄋ一
砂	石少丨丿丶丿	石少丨丿丶丿
莽	艹犬一丿丨丨	艹犬一丿丨丨
泻	氵冖ㄋ一一一	氵冖ㄋ一一一
坪	土平一丶丿一	土平一丶丿一
梳	木亡丿丨ㄋㄋ	木亡丿丨ㄋㄋ
杉	木川丿丿丿丿	木川丿丿丿丿
晤	日五丨ㄋ一一	日五丨ㄋ一一
稚	禾隹丿丨丶一	禾隹丿丨丶一
蔬	艹㇉丨一丨一	艹Z丨一丨一
蝇	虫口丨ㄋ一一	虫口丨ㄋ一一
捣	扌鸟丨ㄋ丨丨	扌鸟丨ㄋ丨丨
顷	七页一丿丨ㄋ	七页一丿丨ㄋ
麽	麻笔ㄋ丶丶丶	麻笔ㄋ丶丶丶
尴	尢丨ㄋ丨丨	尢丨ㄋ丨丨
镖	金西一一丨丿	金西一一丨丿
诧	讠宀丿一ㄋㄋ	讠宀丿一ㄋㄋ
尬	尢人丿丨丨丨	尢人丿丨丨丨
硫	石亡丿丨ㄋㄋ	石亡丿丨ㄋㄋ
羡	羊次丶一丿ㄋ	羊次丶一丿ㄋ
嚼	口爪丨ㄋ丨丨	口爪丨ㄋ丨丨
沦	氵仑丿丶丿ㄋ	氵仑丿丶丿ㄋ
沪	氵户丶ㄋ一丿	氵户丶ㄋ一丿
旷	日广丶一丿丿	日广丶一丿丿
彬	林川丿丿丿丿	林川丿丿丿丿
芽	艹牙一ㄋ丨丿	艹牙一ㄋ丨丿
冥	冖日丶一丿丶	冖日丶一丿丶
狸	犬田丨ㄋ一一	犬田丨ㄋ一一
碳	石山一丿丶丿	石山一丿丶丿
咧	口歹丨丨丨丨	口歹丨丨丨丨
惕	忄日丿ㄋ丿丿	忄日丿ㄋ丿丿
暑	日者一丨一丿	日者一丨一丿
咯	口各丿ㄋ丶丨	口各丿ㄋ丶丨
萝	萝歹丿ㄋ丶丶	萝歹丿ㄋ丶丶
汹	氵乂ㄋ丨丨丨	氵乂ㄋ丨丨丨
腥	月日丿一一丨	月日丿一一丨
窥	穴夫丨ㄋ丿ㄋ	穴夫丨ㄋ丿ㄋ
俺	亻大丨ㄋ一一	亻大丨ㄋ一一
潭	氵西丨ㄋ一一	氵西丨ㄋ一一
崎	山大一丨ㄋ一	山大一丨ㄋ一
麟	鹿米丿ㄋ丶一	鹿米丿ㄋ丶一
捡	扌亼丶丶丿一	扌亼丶丶丿一
厥	广屰丿ㄋ丿丶	广屰丿ㄋ丿丶
拯	扌了ㄋ丿丶一	扌了ㄋ丿丶一
澄	氵一丨ㄋ一	氵祭一丨ㄋ一
哉	口丨ㄋ一一	口丨ㄋ一一
萎	艹禾ㄋ丿一一	艹禾ㄋ丿一一
涡	氵口丨ㄋ丿丶	氵口丨ㄋ丿丶
滔	氵爪丿丨一ㄋ	氵爪丿丨一ㄋ
暇	日叚ㄋ一丨一	日叚ㄋ一丨一
溯	氵屰丿ㄋ一一	氵屰丿ㄋ一一
鳞	鱼米丿ㄋ丶一	鱼米丿ㄋ丶一
酿	西笔ㄋ一一ㄋ	西笔ㄋ一一ㄋ
愕	忄吅一一ㄋㄋ	忄吅一一ㄋㄋ
茵	艹因丨ㄋ一丿	艹因丨ㄋ一丿
暮	莫日丨ㄋ一一	莫日丨ㄋ一一
瞅	目禾丶丿丿丶	目禾丶丿丿丶
衙	彳五丨ㄋ一一	彳五丨ㄋ一一
诫	讠戋一丿丨丨	讠戋一丿丨丨
斧	父丘丿丿一丨	父丘丿丿一丨
兮	八丂一ㄋㄋㄋ	八丂一ㄋㄋㄋ
焕	火鱼丨ㄋ一丿	火鱼丨ㄋ一丿
棕	木宀一一丨丿	木宀一一丨丿
佑	亻石丨ㄋ一一	亻石丨ㄋ一一
嘶	口其丿丿一丨	口其丿丿一丨
妓	女十ㄋ丶丶丶	女十ㄋ丶丶丶
喧	口宀一丨ㄋ一	口宀一丨ㄋ一
蓉	艹穴丿丶丨ㄋ	艹穴丿丶丨ㄋ
删	冂冂一丨丨丨	冂冂一丨丨丨
樱	木贝丨ㄋ丿丶	木贝丨ㄋ丿丶
伺	亻㇉一丨ㄋ一	亻Z一丨ㄋ一
嗡	口公ㄋ丶一ㄋ	口公ㄋ丶一ㄋ
娥	女我丿一丨一	女我丿一丨一
梢	木丨ㄋ一一	木丨ㄋ一一
坝	土贝丨ㄋ丿丶	土贝丨ㄋ丿丶
蚕	天虫丨ㄋ一丨	天虫丨ㄋ一丨
敷	甫方丿一丿丶	甫方丿一丿丶
澜	氵门一丨ㄋ一	氵门一丨ㄋ一
杏	木口丨ㄋ一一	木口丨ㄋ一一
绥	纟爪ㄋ丿一一	纟爪ㄋ丿一一
冶	冫厶丨ㄋ一一	冫厶丨ㄋ一一
挠	扌尧一ㄋ丿一	扌尧一ㄋ丿一
庇	广比一ㄋ丿ㄋ	广比一ㄋ丿ㄋ
搂	扌米ㄋ丿一一	扌米ㄋ丿一一
倏	亻文一丿丶丶	亻文一丿丶丶
婉	女宀丿ㄋ丶ㄋ	女宀丿ㄋ丶ㄋ
聂	耳双ㄋ丶ㄋ丶	耳双ㄋ丶ㄋ丶
噪	口口丨ㄋ一丨	口口丨ㄋ一丨
稼	禾宀一丿ㄋ丿	禾宀一丿ㄋ丿
鳍	鱼者丿ㄋ丨ㄋ	鱼者丿ㄋ丨ㄋ
菱	艹土丿丶丿ㄋ	艹土丿丶丿ㄋ
盏	戋四丨ㄋ丨丨	戋四丨ㄋ丨丨
匿	匚艹一丿丨ㄋ	匚艹一丿丨ㄋ
吱	口十ㄋ丶丶丶	口十ㄋ丶丶丶
寝	宀北ㄋ一一ㄋ	宀北ㄋ一一ㄋ
揽	扌丨ㄋ丿ㄋ	扌丨ㄋ丿ㄋ
髓	骨石一丨一丶	骨石一丨一丶
秉	禾尹ㄋ一一一	禾尹ㄋ一一一
矢	矢丿一一丿丶	矢丿一一丿丶
哺	口甫一丨ㄋ一	口甫一丨ㄋ一
啪	口扌丿丨ㄋ一	口扌丿丨ㄋ一
帜	巾口丿丶丶丶	巾口丿丶丶丶
邵	刀口ㄋ丨丨丨	刀口ㄋ丨丨丨
挟	扌夹丿丶丶丶	扌夹丿丶丶丶
嗽	口束丿ㄋ丿丶	口束丿ㄋ丿丶
缸	缶工一丨一一	缶工一丨一一
揉	扌矛一丨丿丶	扌矛一丨丿丶
腻	月戋一一丨ㄋ	月戋一一丨ㄋ
驯	马川丿丨丨丨	马川丿丨丨丨
缆	纟丨ㄋ丿ㄋ	纟丨ㄋ丿ㄋ
晌	日丨ㄋ一一	日丨ㄋ一一
瘫	疒双丿丨丶一	疒双丿丨丶一
贮	贝宀一一一一	贝宀一一一一
觅	爪见丨ㄋ丿ㄋ	爪见丨ㄋ丿ㄋ
朦	月萝一一丿ㄋ	月萝一一丿ㄋ
僻	亻辟ㄋ一丿丨	亻辟ㄋ一丿丨
隋	耳石一丨一丨	耳石一丨一丨
蔓	艹日丨ㄋ丨丨	艹日丨ㄋ丨丨
咋	口乍丿一丨一	口乍丿一丨一
嵌	山甘丿ㄋ丿丶	山甘丿ㄋ丿丶
虔	虍文丶一丿丶	虍文丶一丿丶
畔	田半丶丿一一	田半丶丿一一
琐	王丨ㄋ丿丶	王丨ㄋ丿丶
碟	石甘ㄋ一丨丿	石甘ㄋ一丨丿
涩	氵刀丶丶丶丶	氵刀丶丶丶丶
胧	月龙一丿ㄋ丿	月龙一丿ㄋ丿
嘟	口者ㄋ丨丨丨	口者ㄋ丨丨丨
蹦	山丿ㄋ一一	山丿ㄋ一一
冢	冖豕丶丶丶丶	冖豕丶丶丶丶
浏	氵文丨丨丨丨	氵文丨丨丨丨
裔	衣冂丿丶丨ㄋ	衣冂丿丶丨ㄋ
襟	衤林一一丨丿	衤林一一丨丿
叨	口刀ㄋ丿丿丿	口刀ㄋ丿丿丿
诀	讠匚丿丶丶丶	讠匚丿丶丶丶
旭	九日丨ㄋ一一	九日丨ㄋ一一
虾	虫下一丨丶丶	虫下一丨丶丶
簿	氵一丨ㄋ一	氵一丨ㄋ一
啤	口卑丿丨ㄋ一	口卑丿丨ㄋ一
擒	扌人丶一丿丶	扌人丶一丿丶
枣	朿冫丶丶丶丶	朿冫丶丶丶丶
嘎	口石丨ㄋ一一	口石丨ㄋ一一
苑	艹歹ㄋㄋㄋㄋ	艹歹ㄋㄋㄋㄋ
牟	厶牛丿一一丨	厶牛丿一一丨
呕	口区一丿丶ㄋ	口区一丿丶ㄋ
骆	马各丿ㄋ丶丨	马各丿ㄋ丶丨
凸	吅丨一丨ㄋ一	吅丨一丨ㄋ一
熄	火自丶ㄋ丶丶	火自丶ㄋ丶丶
兀	笔儿丿ㄋㄋㄋ	笔儿丿ㄋㄋㄋ
喔	口尸一ㄋ丶一	口尸一ㄋ丶一
裳	衣丶一丿ㄋ	衣丶一丿ㄋ
凹	吅丨ㄋ丨ㄋ一	吅丨ㄋ丨ㄋ一
赎	贝十ㄋ丶丶一	贝十ㄋ丶丶一
屯	屯一ㄋ丨ㄋㄋ	屯一ㄋ丨ㄋㄋ
膛	月一丨一一	月一丨一一
浇	氵尧一ㄋ丿一	氵尧一ㄋ丿一
灼	火勹丶丶丶丶	火勹丶丶丶丶
裘	求衣丶一丿ㄋ	求衣丶一丿ㄋ
砰	石平一丶丿一	石平一丶丿一
棘	朿朿一丨ㄋ丨	朿朿一丨ㄋ丨
橡	木象丿ㄋ丨ㄋ	木象丿ㄋ丨ㄋ
聋	龙耳一丨丨一	龙耳一丨丨一
碱	石戊一丨ㄋ一	石戊一丨ㄋ一
姥	女者丿ㄋㄋㄋ	女者丿ㄋㄋㄋ
瑜	王亼丨ㄋ一一	王亼丨ㄋ一一
毋	母ㄋㄋ丿一一	母ㄋㄋ丿一一
娅	女亚一丨丨丶	女亚一丨丨丶
俏	亻丨ㄋ一一	亻丨ㄋ一一
沮	氵目丨ㄋ一一	氵目丨ㄋ一一
萌	艹日丿ㄋ一一	艹日丿ㄋ一一
黯	黑音丶一丶丿	黑音丶一丶丿
撇	扌米丿一丿丶	扌米丿一丿丶
粟	西米丶丿一丨	西米丶丿一丨
尹	尹ㄋ一一丿丿	尹ㄋ一一丿丿
粪	米共一丨丨一	米共一丨丨一
苟	芍口丨ㄋ一一	芍口丨ㄋ一一
癫	疒直丿丶一丿	疒直丿丶一丿
蚂	虫马ㄋㄋ一一	虫马ㄋㄋ一一
禹	笔口丨ㄋ丨一	笔口丨ㄋ丨一
廖	广羽丿丶丿丿	广羽丿丶丿丿
俭	亻亼丶丶丿一	亻亼丶丶丿一
帖	巾占丨一丨ㄋ	巾占丨一丨ㄋ
煎	前水丶丶丶丶	前水丶丶丶丶
缕	纟米ㄋ丿一一	纟米ㄋ丿一一
窦	穴十ㄋ丶丶一	穴十ㄋ丶丶一
簇	族丿一一丿	族丿一一丿
棱	木土丿丶丿ㄋ	木土丿丶丿ㄋ
叩	口卩ㄋ丨丨丨	口卩ㄋ丨丨丨
呐	口内丨ㄋ丿丶	口内丨ㄋ丿丶
瑶	王爪丿一一丨	王爪丿一一丨
墅	田矛一丨一一	田矛一丨一一
莺	萝鸟丿ㄋ丶ㄋ	萝鸟丿ㄋ丶ㄋ
烫	氵㇉丿丿丶丿	氵Z丿丿丶丿
蛙	虫圭一丨一一	虫圭一丨一一
歹	歹一丿ㄋ丶丶	歹一丿ㄋ丶丶
伶	亻令丿丶丶ㄋ	亻令丿丶丶ㄋ
葱	艹勿丶丶ㄋ丶	艹勿丶丶ㄋ丶
哮	口者ㄋ丨一一	口者ㄋ丨一一
眩	目亠ㄋㄋ丶丶	目亠ㄋㄋ丶丶
坤	土日丨丨丨丨	土日丨丨丨丨
廓	广ㄋ丨一ㄋ	广ㄋ丨一ㄋ
讳	讠韦一一ㄋ丨	讠韦一一ㄋ丨
啼	口立丨ㄋ丨丨	口立丨ㄋ丨丨
乍	乍丿一丨一一	乍丿一丨一一
瓣	辛爪丶一丶丿	辛爪丶一丶丿
矫	矢天丿丨丨丨	矢天丿丨丨丨
枉	木王一一丨一	木王一一丨一
跋	石ㄋ丶丶丶	石ㄋ丶丶丶
梗	木更一丨ㄋ一	木更一丨ㄋ一
厕	广贝丨丨丨丨	广贝丨丨丨丨
琢	王豕丶丶丶丶	王豕丶丶丶丶
讥	讠几丿ㄋㄋㄋ	讠几丿ㄋㄋㄋ
釉	釆甲丨ㄋ一丨	釆甲丨ㄋ一丨
窟	穴尸ㄋ丨丨ㄋ	穴尸ㄋ丨丨ㄋ
敛	亼丿一丿丶	亼丿一丿丶
轼	车戋一丨一一	车戋一丨一一
庐	广户丶ㄋ一丿	广户丶ㄋ一丿
胚	月不一一一一	月不一一一一
呻	口日丨丨丨丨	口日丨丨丨丨
绰	纟卜丨ㄋ一一	纟卜丨ㄋ一一
扼	扌广ㄋㄋㄋㄋ	扌广ㄋㄋㄋㄋ
懿	豆丶一丿ㄋ	豆丶一丿ㄋ
炯	火冂丨ㄋ一一	火冂丨ㄋ一一
竿	舌一一丨丨	舌一一丨丨
慷	忄广ㄋ一一丨	忄广ㄋ一一丨
虞	虍口一一丿丶	虍口一一丿丶
锤	金垂丿一丨一	金垂丿一丨一
栓	木人一一丨一	木人一一丨一
桨	北歹一丨丿丶	北歹一丨丿丶
蚊	虫文丶一丿丶	虫文丶一丿丶
磅	石立丶一ㄋ丿	石立丶一ㄋ丿
孽	艹笔丨ㄋ一ㄋ	艹笔丨ㄋ一ㄋ
惭	忄车丿丿一丨	忄车丿丿一丨
戳	羽隹一ㄋ丿丶	羽隹一ㄋ丿丶
禀	亠回一一丨丿	亠回一一丨丿
鄂	吅二ㄋㄋ丨丨	吅二ㄋㄋ丨丨
馈	食丨ㄋ丿丶	食丨ㄋ丿丶
垣	土笔丨ㄋ一一	土笔丨ㄋ一一
溅	氵贝一一ㄋ丿	氵贝一一ㄋ丿
咚	口文丶丶丶丶	口文丶丶丶丶
礁	石隹丶丶丶丶	石隹丶丶丶丶
钙	金笔丨一ㄋㄋ	金笔丨一ㄋㄋ
彰	音十丿丿丿丿	音十丿丿丿丿
眯	目米丶丿一丨	目米丶丿一丨
豁	宀丰丨ㄋ一丿	宀丰丨ㄋ一丿
雯	文丶一丿丶	文丶一丿丶
磷	石米丿ㄋ丶一	石米丿ㄋ丶一
墟	土虍丨丨丶丿	土虍丨丨丶丿
迂	于辶丶ㄋ丶丶	于辶丶ㄋ丶丶
瞻	目厃丿丶丶一	目厃丿丶丶一
颅	卜尸一丿丨ㄋ	卜尸一丿丨ㄋ
琉	王亡丿丨ㄋㄋ	王亡丿丨ㄋㄋ
悼	忄卜丨ㄋ一一	忄卜丨ㄋ一一
蝴	虫古丿ㄋ一一	虫古丿ㄋ一一
拣	扌车ㄋ丿丶丶	扌车ㄋ丿丶丶
渺	氵目丨丿丶丿	氵目丨丿丶丿
眷	目丨ㄋ一一	目丨ㄋ一一
悯	忄门丶一丿丶	忄门丶一丿丶
汰	氵大丶丶丶丶	氵大丶丶丶丶
慑	忄耳ㄋ丶ㄋ丶	忄耳ㄋ丶ㄋ丶
婶	女宀丨ㄋ一一	女宀丨ㄋ一一
斐	非文丶一丿丶	非文丶一丿丶
嘘	口虍丨丨丶丿	口虍丨丨丶丿
镶	金亠丨ㄋ一丨	金亠丨ㄋ一丨
炕	火亠丿ㄋㄋㄋ	火亠丿ㄋㄋㄋ
宦	宀臣一丨ㄋ一	宀臣一丨ㄋ一
趴	八丿丶丶丶	八丿丶丶丶
绷	纟月丿ㄋ一一	纟月丿ㄋ一一
窘	穴尹丨ㄋ一一	穴尹丨ㄋ一一
襄	亠吅一一丨丨	亠吅一一丨丨
珀	王白丿丨ㄋ一	王白丿丨ㄋ一
嚣	吅页丨ㄋ一丨	吅页丨ㄋ一丨
拚	扌厶一丿丨丨	扌厶一丿丨丨
酌	西勹丶丶丶丶	西勹丶丶丶丶
浊	氵虫丨ㄋ一丨	氵虫丨ㄋ一丨
毓	母丶一ㄋ丶	母丶一ㄋ丶
撼	扌戊一丨ㄋ一	扌戊一丨ㄋ一
嗜	口者丿ㄋ丨ㄋ	口者丿ㄋ丨ㄋ
扛	扌工一丨一一	扌工一丨一一
峭	山丨ㄋ一一	山丨ㄋ一一
磕	石去丨ㄋ丨丨	石去丨ㄋ丨丨
翘	尧羽ㄋ丶一ㄋ	尧羽ㄋ丶一ㄋ
槽	木笔丨ㄋ一丨	木笔丨ㄋ一丨
栅	木冂丨ㄋ一一	木冂丨ㄋ一一
淌	氵丨ㄋ丨ㄋ	氵丨ㄋ丨ㄋ
颓	禾几一丿丨ㄋ	禾几一丿丨ㄋ
熏	舌黑丨ㄋ丶丿	舌黑丨ㄋ丶丿
瑛	王艹丨ㄋ一丿	王艹丨ㄋ一丿
忖	忄寸一丨丶丶	忄寸一丨丶丶
颐	臣页一丿丨ㄋ	臣页一丿丨ㄋ
牡	牛土一丨一一	牛土一丨一一
缀	纟双ㄋ丶ㄋ丶	纟双ㄋ丶ㄋ丶
徊	彳回丨ㄋ丨ㄋ	彳回丨ㄋ丨ㄋ
梨	禾刂一丨丿丶	禾刂一丨丿丶
肪	月方丶一ㄋ丿	月方丶一ㄋ丿
涕	氵弓丶丿ㄋ一	氵弓丶丿ㄋ一
惫	文田丶ㄋ丶丶	文田丶ㄋ丶丶
摹	莫手丿一一丨	莫手丿一一丨
踱	度ㄋ丶丶丶	度ㄋ丶丶丶
肘	月寸一丨丶丶	月寸一丨丶丶
挚	执手丿一一丨	执手丿一一丨
熔	火穴丿丶丨ㄋ	火穴丿丶丨ㄋ
氯	气尹丨ㄋ丿丶	气尹丨ㄋ丿丶
凛	冫亠丨ㄋ丨ㄋ	冫亠丨ㄋ丨ㄋ
绎	纟双一一丨丨	纟双一一丨丨
庶	度水丶丶丶丶	度水丶丶丶丶
脯	月甫一丨ㄋ一	月甫一丨ㄋ一
迭	笔夫丶ㄋ丶丶	笔夫丶ㄋ丶丶
睦	目土丿丶一丨	目土丿丶一丨
窍	穴工一ㄋㄋㄋ	穴工一ㄋㄋㄋ
粥	弓米ㄋ一ㄋㄋ	弓米ㄋ一ㄋㄋ
庵	广大丨ㄋ一一	广大丨ㄋ一一
沧	氵人ㄋㄋㄋㄋ	氵人ㄋㄋㄋㄋ
沁	氵心丶ㄋ丶丶	氵心丶ㄋ丶丶
奕	亦大一丿丶丶	亦大一丿丶丶
怠	厶口丶ㄋ丶丶	厶口丶ㄋ丶丶
咙	口龙一丿ㄋ丿	口龙一丿ㄋ丿
氨	气宀ㄋ丿一一	气宀ㄋ丿一一
矗	直直一丨丨ㄋ	直直一丨丨ㄋ
盔	石火丨ㄋ丨丨	石火丨ㄋ丨丨
拇	扌母ㄋㄋ丶一	扌母ㄋㄋ丶一
沛	氵笔丨ㄋ丨丨	氵笔丨ㄋ丨丨
榻	木日ㄋ丶一ㄋ	木日ㄋ丶一ㄋ
揣	扌山一丿丨ㄋ	扌山一丿丨ㄋ
崭	山车丿丿一丨	山车丿丿一丨
鞘	革丨ㄋ一一	革丨ㄋ一一
鞠	革勹丶丿一丨	革勹丶丿一丨
垦	艮土一丨一一	艮土一丨一一
唾	口垂丿一丨一	口垂丿一丨一
洽	氵合丿丶一丨	氵合丿丶一丨
橱	木广一丨ㄋ一	木广一丨ㄋ一
仕	亻土一丨一一	亻土一丨一一
蜘	虫矢丨ㄋ一一	虫矢丨ㄋ一一
痰	疒火丶丿丿丶	疒火丶丿丿丶
袜	衤未丨丿丶丶	衤未丨丿丶丶
峙	山土一丨丶丶	山土一丨丶丶
柬	束冫丶丶丶丶	束冫丶丶丶丶
蝉	虫单丶丿丨ㄋ	虫单丶丿丨ㄋ
蟹	角刀丿一一丨	角刀丿一一丨
谏	讠束丶丶丶丶	讠束丶丶丶丶
擎	芍口丿一丿丶	芍口丿一丿丶
鹃	口月丿ㄋ丶ㄋ	口月丿ㄋ丶ㄋ
皓	白告丿一丨一	白告丿一丨一
朕	月䒑一丿丶丶	月首一丿丶丶
疤	疒巴ㄋ丨一ㄋ	疒巴ㄋ丨一ㄋ
禺	日内丨ㄋ丨一	日内丨ㄋ丨一
铲	金立一丿丿丿	金立一丿丿丿
酶	西ㄋㄋ丶一	西ㄋㄋ丶一
钝	金屯一ㄋ丨ㄋ	金屯一ㄋ丨ㄋ
氓	亡民ㄋ一ㄋ一	亡民ㄋ一ㄋ一
匣	匚甲丨ㄋ一一	匚甲丨ㄋ一一
弧	弓爪丿丿ㄋ丶	弓爪丿丿ㄋ丶
峨	山我丿一丨一	山我丿一丨一
锥	金隹丿丨丶一	金隹丿丨丶一
揪	扌禾丶丿丿丶	扌禾丶丿丿丶
杠	木工一丨一一	木工一丨一一
吭	口亠丿ㄋㄋㄋ	口亠丿ㄋㄋㄋ
崛	山尸ㄋ丨丨ㄋ	山尸ㄋ丨丨ㄋ
诬	讠工丿丶丿丶	讠工丿丶丿丶
冉	冂土一丨一一	冂土一丨一一
抒	扌矛ㄋ丶ㄋ丨	扌矛ㄋ丶ㄋ丨
庚	广尹丿丶丶丶	广尹丿丶丶丶
悍	忄日一一丨丨	忄日一一丨丨
靡	麻非丨一一一	麻非丨一一一
晦	日ㄋㄋ丶一	日ㄋㄋ丶一
醋	西共丨ㄋ一一	西共丨ㄋ一一
夭	天丿一丿丶丶	天丿一丿丶丶
锯	金尸一丨丨ㄋ	金尸一丨丨ㄋ
壕	土一丿ㄋ丿	土一丿ㄋ丿
咦	口大ㄋ一ㄋㄋ	口大ㄋ一ㄋㄋ
侈	亻歹丿ㄋ丶丶	亻歹丿ㄋ丶丶
婢	女卑丿丨ㄋ一	女卑丿丨ㄋ一
猾	犬骨丨ㄋㄋ丶	犬骨丨ㄋㄋ丶
徘	彳非丨一一一	彳非丨一一一
硝	石丨ㄋ一一	石丨ㄋ一一
煽	火户ㄋ丶一ㄋ	火户ㄋ丶一ㄋ
皂	白七一ㄋㄋㄋ	白七一ㄋㄋㄋ
嗦	口ㄋㄋ丶丨	口ㄋㄋ丶丨
舵	舟宀丿ㄋㄋㄋ	舟宀丿ㄋㄋㄋ
靴	革化丿丨丿ㄋ	革化丿丨丿ㄋ
狈	犬贝丨ㄋ丿丶	犬贝丨ㄋ丿丶
捂	扌五丨ㄋ一一	扌五丨ㄋ一一
郝	赤耳ㄋ丨丨丨	赤耳ㄋ丨丨丨
疮	疒人ㄋㄋㄋㄋ	疒人ㄋㄋㄋㄋ
苛	艹可一丨ㄋ一	艹可一丨ㄋ一
秽	禾山丿ㄋ丶丶	禾山丿ㄋ丶丶
茜	艹西一丨ㄋ丿	艹西一丨ㄋ丿
搓	扌羊一丨一一	扌羊一丨一一
芸	艹云一一ㄋ丶	艹云一一ㄋ丶
酱	北歹一丨ㄋ丿	北歹一丨ㄋ丿
赁	亻王丨ㄋ丿丶	亻王丨ㄋ丿丶
檐	木厃丿丶丶一	木厃丿丶丶一
饷	食丨ㄋ一一	食丨ㄋ一一
蕉	艹隹丶丶丶丶	艹隹丶丶丶丶
铀	金甲丨ㄋ一丨	金甲丨ㄋ一丨
苔	艹厶丨ㄋ一一	艹厶丨ㄋ一一
赦	赤文丿一丿丶	赤文丿一丿丶
缎	纟段丿丨一一	纟段丿丨一一
舷	舟亠ㄋㄋ丶丶	舟亠ㄋㄋ丶丶
筷	忄ㄋ一丿丶	忄ㄋ一丿丶
朔	屰月丿ㄋ一一	屰月丿ㄋ一一
婪	林女ㄋ丿一一	林女ㄋ丿一一
紊	文糸ㄋㄋ丶丨	文糸ㄋㄋ丶丨
厮	广其丿丿一丨	广其丿丿一丨
婿	女走丨ㄋ一一	女走丨ㄋ一一
寥	宀羽丿丶丿丿	宀羽丿丶丿丿
兢	古儿一丨丨ㄋ	古儿一丨丨ㄋ
糙	米告丶ㄋ丶丶	米告丶ㄋ丶丶
卦	圭卜丨丶丶丶	圭卜丨丶丶丶
槐	木鬼丿丨ㄋ一	木鬼丿丨ㄋ一
扒	扌八丿丶丶丶	扌八丿丶丶丶
裴	非衣丶一丿ㄋ	非衣丶一丿ㄋ
祀	衤巴ㄋ一ㄋㄋ	衤巴ㄋ一ㄋㄋ
埔	土甫一丨ㄋ一	土甫一丨ㄋ一
絮	女口ㄋㄋ丶丨	女口ㄋㄋ丶丨
芭	艹巴ㄋ丨一ㄋ	艹巴ㄋ丨一ㄋ
屉	尸甘ㄋㄋㄋㄋ	尸甘ㄋㄋㄋㄋ
霄	丨ㄋ一一	丨ㄋ一一
痪	疒鱼丨ㄋ一丿	疒鱼丨ㄋ一丿
绽	纟定丶丶ㄋ一	纟定丶丶ㄋ一
宵	宀丨ㄋ一一	宀丨ㄋ一一
邑	口巴ㄋ丨一ㄋ	口巴ㄋ丨一ㄋ
霖	林一丨丿丶	林一丨丿丶
岔	分山丨ㄋ丨丨	分山丨ㄋ丨丨
茄	艹加ㄋ丿丨ㄋ	艹加ㄋ丿丨ㄋ
饵	食耳一丨丨一	食耳一丨丨一
韧	韦刀丶丶丶丶	韦刀丶丶丶丶
琪	王其一丨丨一	王其一丨丨一
邹	刍耳ㄋ丨丨丨	刍耳ㄋ丨丨丨
瑚	王古丿ㄋ一一	王古丿ㄋ一一
憋	米文丶ㄋ丶丶	米文丶ㄋ丶丶
殆	歹厶丨ㄋ一一	歹厶丨ㄋ一一
噜	口鱼丨ㄋ一一	口鱼丨ㄋ一一
忒	戋心丶ㄋ丶丶	戋心丶ㄋ丶丶
忿	分心丶ㄋ丶丶	分心丶ㄋ丶丶
衅	笔四丶丿一一	笔四丶丿一一
淳	氵ㄋ丨一一	氵ㄋ丨一一
悖	忄ㄋ丨一一	忄ㄋ丨一一
髦	长毛丿一一ㄋ	长毛丿一一ㄋ
孜	子文丿一丿丶	子文丿一丿丶
粤	米一ㄋㄋㄋ	米一ㄋㄋㄋ
隘	耳䒑丿丶丨ㄋ	耳首丿丶丨ㄋ
濒	氵止丨丿丿一	氵止丨丿丿一
铮	金争丿ㄋㄋ一	金争丿ㄋㄋ一
畸	田大一丨ㄋ一	田大一丨ㄋ一
剔	日勿丨丨丨丨	日勿丨丨丨丨
坞	土勹ㄋ一一一	土勹ㄋ一一一
篱	㐫丨ㄋㄋ丶	离丨ㄋㄋ丶
淀	氵定丶丶ㄋ一	氵定丶丶ㄋ一
蓦	莫马ㄋㄋ一一	莫马ㄋㄋ一一
唬	口虍丿ㄋㄋㄋ	口虍丿ㄋㄋㄋ
锣	金四丿ㄋ丶丶	金四丿ㄋ丶丶
汀	氵于一丨丨丨	氵于一丨丨丨
趾	止丨一丨一	止丨一丨一
缉	纟口一丨丨一	纟口一丨丨一
嫦	女丨ㄋ丨丨	女丨ㄋ丨丨
斟	其乙丶丶一丨	其乙丶丶一丨
鞍	革宀ㄋ丿一一	革宀ㄋ丿一一
扳	扌广ㄋ丶丶丶	扌广ㄋ丶丶丶
拴	扌人一一丨一	扌人一一丨一
诅	讠目丨ㄋ一一	讠目丨ㄋ一一
谟	讠莫一丨丨丨	讠莫一丨丨丨
呃	口广ㄋㄋㄋㄋ	口广ㄋㄋㄋㄋ
懦	忄一丿丨ㄋ	忄一丿丨ㄋ
逞	口王丶ㄋ丶丶	口王丶ㄋ丶丶
忏	忄舌丿一丨丨	忄舌丿一丨丨
犁	禾刂丿一一丨	禾刂丿一一丨
拧	扌宀一丨丨丨	扌宀一丨丨丨
叱	口七一ㄋㄋㄋ	口七一ㄋㄋㄋ
佟	亻文丶丶丶丶	亻文丶丶丶丶
亥	亥丶一ㄋ丿丿	亥丶一ㄋ丿丿
舜	歹一ㄋ丨丨	歹一ㄋ丨丨
龚	龙共一丨丨一	龙共一丨丨一
绊	纟半丶丿一一	纟半丶丿一一
腮	月田丶ㄋ丶丶	月田丶ㄋ丶丶
邸	氏笔ㄋ丨丨丨	氏笔ㄋ丨丨丨
蔚	艹尸一一丨丿	艹尸一一丨丿
椒	木上丨丿丶ㄋ	木上丨丿丶ㄋ
湛	氵其ㄋㄋㄋㄋ	氵其ㄋㄋㄋㄋ
狩	犬宀一丨丶丶	犬宀一丨丶丶
眶	目匚一一丨一	目匚一一丨一
栈	木戋一一ㄋ丿	木戋一一ㄋ丿
薇	艹丿ㄋㄋㄋ	艹丿ㄋㄋㄋ
肮	月亠丿ㄋㄋㄋ	月亠丿ㄋㄋㄋ
瀑	氵日一丨丨一	氵日一丨丨一
渣	氵木丨ㄋ一一	氵木丨ㄋ一一
褂	衤圭丨丶丶丶	衤圭丨丶丶丶
叽	口几丿ㄋㄋㄋ	口几丿ㄋㄋㄋ
臀	尸共丨ㄋ一一	尸共丨ㄋ一一
妞	女丑ㄋ丨一一	女丑ㄋ丨一一
巍	山禾ㄋ丿一丿	山禾ㄋ丿一丿
唔	口五丨ㄋ一一	口五丨ㄋ一一
疚	疒久丿ㄋ丶丶	疒久丿ㄋ丶丶
戎	戋石一丿丿丿	戋石一丿丿丿
鲤	鱼田丨ㄋ一一	鱼田丨ㄋ一一
肇	户文ㄋ一一一	户文ㄋ一一一
笃	马ㄋㄋ一一	马ㄋㄋ一一
娴	女门一丨丿丶	女门一丨丿丶
辙	车亡丨ㄋ一一	车亡丨ㄋ一一
阮	耳元一一丿ㄋ	耳元一一丿ㄋ
札	木乙ㄋㄋㄋㄋ	木乙ㄋㄋㄋㄋ
懊	忄丶丿一丨	忄丶丿一丨
焘	丰寸丶丶丶丶	丰寸丶丶丶丶
恤	忄笔丨ㄋ丨丨	忄笔丨ㄋ丨丨
疹	疒人丿丿丿丿	疒人丿丿丿丿
潇	氵艹ㄋ一一丨	氵艹ㄋ一一丨
铝	金口丨ㄋ一一	金口丨ㄋ一一
涤	氵文一丨丿丶	氵文一丨丿丶
喽	口米ㄋ丿一一	口米ㄋ丿一一
恃	忄土一丨丶丶	忄土一丨丶丶
砌	石七ㄋ丿丿丿	石七ㄋ丿丿丿
楞	木四丶一ㄋ丿	木四丶一ㄋ丿
遁	广十丨ㄋ一一	广十丨ㄋ一一
阱	耳二一一丿丨	耳二一一丿丨
咎	文卜丨ㄋ一一	文卜丨ㄋ一一
洼	氵圭一丨一一	氵圭一丨一一
炳	火丙丿丶丶丶	火丙丿丶丶丶
噬	口一丨一丿	口一丨一丿
枫	木几丿丶丶丶	木几丿丶丶丶
拷	扌者一ㄋㄋㄋ	扌者一ㄋㄋㄋ
哆	口歹丿ㄋ丶丶	口歹丿ㄋ丶丶
矶	石几丿ㄋㄋㄋ	石几丿ㄋㄋㄋ
苇	艹韦一一ㄋ丨	艹韦一一ㄋ丨
翩	户ㄋ丶一ㄋ	户ㄋ丶一ㄋ
窒	穴至一ㄋ丶一	穴至一ㄋ丶一
侬	亻农丶ㄋ丿ㄋ	亻农丶ㄋ丿ㄋ
靶	革巴ㄋ丨一ㄋ	革巴ㄋ丨一ㄋ
胰	月大ㄋ一ㄋㄋ	月大ㄋ一ㄋㄋ
芜	艹笔一丿ㄋㄋ	艹笔一丿ㄋㄋ
妾	立女ㄋ丿一一	立女ㄋ丿一一
嚎	口一丿ㄋ丿	口一丿ㄋ丿
辫	辛纟丶一丶丿	辛纟丶一丶丿
踉	笔ㄋ一一ㄋ	笔ㄋ一一ㄋ
幌	巾日丨丶丿一	巾日丨丶丿一
佃	亻田丨ㄋ一丨	亻田丨ㄋ一丨
葫	艹古丿ㄋ一一	艹古丿ㄋ一一
拽	扌日ㄋ丶丶丶	扌日ㄋ丶丶丶
皖	白宀一一丿ㄋ	白宀一一丿ㄋ
滤	氵虍丶ㄋ丶丶	氵虍丶ㄋ丶丶
睬	目爪一丨丿丶	目爪一丨丿丶
俞	亼月丨丨丨丨	亼月丨丨丨丨
匕	七丿ㄋㄋㄋㄋ	七丿ㄋㄋㄋㄋ
嗤	口山一丨ㄋ一	口山一丨ㄋ一
谤	讠立丶一ㄋ丿	讠立丶一ㄋ丿
捍	扌日一一丨丨	扌日一一丨丨
孵	留笔丿丿丶丶	留笔丿丿丶丶
倪	亻鼠丿ㄋㄋㄋ	亻鼠丿ㄋㄋㄋ
瘾	疒耳丿ㄋㄋ一	疒耳丿ㄋㄋ一
敝	米文丿一丿丶	米文丿一丿丶
匡	匚王一一丨一	匚王一一丨一
绫	纟土丿丶丿ㄋ	纟土丿丶丿ㄋ
磋	石羊一丨一一	石羊一丨一一
尧	尧一ㄋ丿一一	尧一ㄋ丿一一
淆	氵乂一丿丿ㄋ	氵乂一丿丿ㄋ
蕊	艹心丶ㄋ丶丶	艹心丶ㄋ丶丶
烘	火共一丨丨一	火共一丨丨一
璋	王音一丨丨丨	王音一丨丨丨
轧	车乙ㄋㄋㄋㄋ	车乙ㄋㄋㄋㄋ
亢	亠几丿ㄋㄋㄋ	亠几丿ㄋㄋㄋ
赂	贝各丿ㄋ丶丨	贝各丿ㄋ丶丨
榆	木亼丨ㄋ一一	木亼丨ㄋ一一
蝗	虫白一一丨一	虫白一一丨一
诛	讠笔丨丿丶丶	讠笔丨丿丶丶
骏	马厶丿丶丿ㄋ	马厶丿丶丿ㄋ
勺	勹笔丶丶丶丶	勹笔丶丶丶丶
梵	林几丶丶丶丶	林几丶丶丶丶
炽	火口丿丶丶丶	火口丿丶丶丶
笠	立丶一丶丿	立丶一丶丿
颌	合页一丿丨ㄋ	合页一丿丨ㄋ
闸	门甲丨ㄋ一一	门甲丨ㄋ一一
狒	犬弓ㄋ一ㄋㄋ	犬弓ㄋ一ㄋㄋ
樊	木乂丿丶一丨	木乂丿丶一丨
镕	金穴丿丶丨ㄋ	金穴丿丶丨ㄋ
缪	纟羽丿丶丿丿	纟羽丿丶丿丿
瘟	疒日丨ㄋ丨丨	疒日丨ㄋ丨丨
垢	土广一丨ㄋ一	土广一丨ㄋ一
菇	艹女一丨丨ㄋ	艹女一丨丨ㄋ
琦	王大一丨ㄋ一	王大一丨ㄋ一
剃	弓刂丨丨丨丨	弓刂丨丨丨丨
迸	䒑开丶ㄋ丶丶	首开丶ㄋ丶丶
炫	火亠ㄋㄋ丶丶	火亠ㄋㄋ丶丶
溺	氵弓丶一丶一	氵弓丶一丶一
惚	忄勿丶ㄋ丶丶	忄勿丶ㄋ丶丶
嗨	口氵丿一ㄋㄋ	口氵丿一ㄋㄋ
陨	耳口丨ㄋ丿丶	耳口丨ㄋ丿丶
赃	贝广一丨一一	贝广一丨一一
羁	四革ㄋㄋ一一	四革ㄋㄋ一一
嘀	口立丨ㄋ一丨	口立丨ㄋ一丨
臻	至一丨丿丶	至一丨丿丶
膳	月羊丶丿一丨	月羊丶丿一丨
赣	音十丿ㄋ丶一	音十丿ㄋ丶一
踌	丰一丨丶丶	丰一丨丶丶
殉	歹勹丨ㄋ一一	歹勹丨ㄋ一一
桔	木吉一丨一丨	木吉一丨一丨
瞿	目目丿丨丶一	目目丿丨丶一
闽	门虫丨ㄋ一丨	门虫丨ㄋ一丨
豚	月豕一丿ㄋ丿	月豕一丿ㄋ丿
沌	氵屯一ㄋ丨ㄋ	氵屯一ㄋ丨ㄋ
掺	扌厶丿丿丿丿	扌厶丿丿丿丿
喳	口木丨ㄋ一一	口木丨ㄋ一一
惰	忄石一丨一丨	忄石一丨一丨
椭	木耳一丿丨ㄋ	木耳一丿丨ㄋ
咪	口米丶丿一丨	口米丶丿一丨
霎	立ㄋ丿一一	立ㄋ丿一一
侃	亻口丿丨ㄋㄋ	亻口丿丨ㄋㄋ
猝	犬亠丿丶丿丶	犬亠丿丶丿丶
戮	羽人丿丿丿一	羽人丿丿丿一
窖	穴告丿一丨一	穴告丿一丨一
祠	衤㇉一丨ㄋ一	衤Z一丨ㄋ一
菁	艹青一一丨一	艹青一一丨一
瞩	目尸丿丨ㄋ一	目尸丿丨ㄋ一
佬	亻者丿ㄋㄋㄋ	亻者丿ㄋㄋㄋ
躇	艹一丨一丿	艹一丨一丿
肋	月力ㄋ丿丿丿	月力ㄋ丿丿丿
咄	口山ㄋ丨丨丨	口山ㄋ丨丨丨
忡	忄中丨ㄋ一丨	忄中丨ㄋ一丨
雍	亠幺丿丿丨丶	亠幺丿丿丨丶
蕾	艹丨ㄋ一丨	艹丨ㄋ一丨
忱	忄冖丿ㄋㄋㄋ	忄冖丿ㄋㄋㄋ
跄	人ㄋㄋㄋㄋ	人ㄋㄋㄋㄋ
硅	石圭一丨一一	石圭一丨一一
伎	亻十ㄋ丶丶丶	亻十ㄋ丶丶丶
炊	火欠丿ㄋ丿丶	火欠丿ㄋ丿丶
钊	金刂丨丨丨丨	金刂丨丨丨丨
蝠	虫鬲丨ㄋ一丨	虫鬲丨ㄋ一丨
拭	扌戋一丨一一	扌戋一丨一一
屎	尸米丶丿一丨	尸米丶丿一丨
谛	讠立丨ㄋ丨丨	讠立丨ㄋ丨丨
褪	衤艮丶ㄋ丶丶	衤艮丶ㄋ丶丶
丞	了水一一一一	了水一一一一
卉	十开一丿丨丨	十开一丿丨丨
隧	耳冫一丿ㄋ丿	耳冫一丿ㄋ丿
茸	艹耳一丨丨一	艹耳一丨丨一
钳	金甘一丨丨一	金甘一丨丨一
啃	口止丨ㄋ一一	口止丨ㄋ一一
伢	亻牙一ㄋ丨丿	亻牙一ㄋ丨丿
舔	舌天丨丶丶丶	舌天丨丶丶丶
闺	门圭一丨一一	门圭一丨一一
蹬	一丨ㄋ一	祭一丨ㄋ一
眺	目儿丶一丿丶	目儿丶一丿丶
挛	亦手丿一一丨	亦手丿一一丨
袱	衤亻一丿丶丶	衤亻一丿丶丶
陇	耳龙一丿ㄋ丿	耳龙一丿ㄋ丿
殴	区殳丿ㄋㄋ丶	区殳丿ㄋㄋ丶
柿	木亠丨ㄋ丨丨	木亠丨ㄋ丨丨
梧	木五丨ㄋ一一	木五丨ㄋ一一
惺	忄日丿一一丨	忄日丿一一丨
琛	王冖丿丶一丨	王冖丿丶一丨
弛	弓也ㄋ丨ㄋㄋ	弓也ㄋ丨ㄋㄋ
侥	亻尧一ㄋ丿一	亻尧一ㄋ丿一
捅	扌甬ㄋ丶丨ㄋ	扌甬ㄋ丶丨ㄋ
酝	西云一一ㄋ丶	西云一一ㄋ丶
薯	萝者一丨一丿	萝者一丨一丿
曳	日乙丶丶丶丶	日乙丶丶丶丶
澈	氵亡丨ㄋ一一	氵亡丨ㄋ一一
锈	金禾ㄋ丿丿丿	金禾ㄋ丿丿丿
稠	禾冂一丨一丨	禾冂一丨一丨
眸	目厶丿一一丨	目厶丿一一丨
咆	口勹ㄋ一ㄋㄋ	口勹ㄋ一ㄋㄋ
簧	共丨ㄋ一丨	共丨ㄋ一丨
鸥	区鸟丿ㄋ丶ㄋ	区鸟丿ㄋ丶ㄋ
疡	疒㇉丿丿丿丿	疒Z丿丿丿丿
渎	氵十ㄋ丶丶一	氵十ㄋ丶丶一
嬉	女壴丨ㄋ一一	女壴丨ㄋ一一
汲	氵及丿ㄋ丶丶	氵及丿ㄋ丶丶
脓	月农丶ㄋ丿ㄋ	月农丶ㄋ丿ㄋ
穗	禾笔丨ㄋ一一	禾笔丨ㄋ一一
骡	马田ㄋㄋ丶丨	马田ㄋㄋ丶丨
拎	扌令丿丶丶ㄋ	扌令丿丶丶ㄋ
巳	巴ㄋ一ㄋㄋㄋ	巴ㄋ一ㄋㄋㄋ
邢	开耳ㄋ丨丨丨	开耳ㄋ丨丨丨
槛	木丨ㄋ丨丨	木丨ㄋ丨丨
廿	甘一丨丨一一	甘一丨丨一一
搀	扌象丿ㄋ丶丶	扌象丿ㄋ丶丶
曙	日四一丨一丿	日四一丨一丿
樵	木隹丶丶丶丶	木隹丶丶丶丶
隅	耳日丨ㄋ丨一	耳日丨ㄋ丨一
筛	刂一丨ㄋ丨	刂一丨ㄋ丨
谒	讠日丿ㄋ丿丶	讠日丿ㄋ丿丶
倭	亻禾ㄋ丿一一	亻禾ㄋ丿一一
痹	疒田丨ㄋ一丨	疒田丨ㄋ一丨
猖	犬日丨ㄋ一一	犬日丨ㄋ一一
佯	亻羊丶丿一一	亻羊丶丿一一
奚	爪幺一丿丶丶	爪幺一丿丶丶
肛	月工一丨一一	月工一丨一一
甭	不甬丿ㄋ一一	不甬丿ㄋ一一
抨	扌平一丶丿一	扌平一丶丿一
蛾	虫我丿一丨一	虫我丿一丨一
唠	口萝ㄋ丿丿丿	口萝ㄋ丿丿丿
嵩	山丨ㄋ一一	山丨ㄋ一一
荧	萝火丶丿丿丶	萝火丶丿丿丶
漱	氵束丿ㄋ丿丶	氵束丿ㄋ丿丶
酋	酋丶丿一丨ㄋ	酋丶丿一丨ㄋ
攘	扌亠丨ㄋ一丨	扌亠丨ㄋ一丨
诘	讠吉一丨一丨	讠吉一丨一丨
篡	目一丿丶ㄋ	目一丿丶ㄋ
睿	卜冖一丿丶丿	卜冖一丿丶丿
噩	王口丨ㄋ一丨	王口丨ㄋ一丨
怅	忄长丿一ㄋ丶	忄长丿一ㄋ丶
盎	冂大丨ㄋ丨丨	冂大丨ㄋ丨丨
徙	彳止丨一丿丶	彳止丨一丿丶
鞅	革冂一丿丶丶	革冂一丿丶丶
漓	氵㐫丨ㄋㄋ丶	氵离丨ㄋㄋ丶
祟	山冂一一丨丿	山冂一一丨丿
睫	目笔ㄋ一一丨	目笔ㄋ一一丨
攸	亻文丿一丿丶	亻文丿一丿丶
翎	令羽ㄋ丶一ㄋ	令羽ㄋ丶一ㄋ
呛	口人ㄋㄋㄋㄋ	口人ㄋㄋㄋㄋ
檀	木亠丨ㄋ丨ㄋ	木亠丨ㄋ丨ㄋ
筐	匚一一丨一	匚一一丨一
堑	车丘一丨一一	车丘一丨一一
寅	宀笔丨ㄋ一丨	宀笔丨ㄋ一丨
磊	石石一丿丨ㄋ	石石一丿丨ㄋ
驭	马双ㄋ丶丶丶	马双ㄋ丶丶丶
惘	忄冂丶丿一丶	忄冂丶丿一丶
吠	口犬一丿丶丶	口犬一丿丶丶
驮	马大一丿丶丶	马大一丿丶丶
瑙	王川丿丨ㄋ丿	王川丿丨ㄋ丿
炬	火匚ㄋ一一一	火匚ㄋ一一一
痉	疒轻ㄋ丶一丨	疒轻ㄋ丶一丨
恺	忄山ㄋ一ㄋㄋ	忄山ㄋ一ㄋㄋ
曝	日日一丨丨一	日日一丨丨一
萤	萝虫丨ㄋ一丨	萝虫丨ㄋ一丨
胺	月宀ㄋ丿一一	月宀ㄋ丿一一
敕	束文丿一丿丶	束文丿一丿丶
筝	争丿ㄋㄋ一	争丿ㄋㄋ一
幡	巾釆丨ㄋ一丨	巾釆丨ㄋ一丨
霹	辟ㄋ一丿丨	辟ㄋ一丿丨
竺	二一一一一	二一一一一
烙	火各丿ㄋ丶丨	火各丿ㄋ丶丨
毗	田比一ㄋ丿ㄋ	田比一ㄋ丿ㄋ
鸠	九鸟丿ㄋ丶ㄋ	九鸟丿ㄋ丶ㄋ
蒜	艹示一一丨丿	艹示一一丨丿
埠	土笔丨ㄋ一ㄋ	土笔丨ㄋ一ㄋ
阜	笔吅一丨丨丨	笔吅一丨丨丨
嘈	口笔丨ㄋ一丨	口笔丨ㄋ一丨
帷	巾隹丿丨丶一	巾隹丿丨丶一
乒	丘笔丿丿丿丿	丘笔丿丿丿丿
啄	口豕丶丶丶丶	口豕丶丶丶丶
鳌	敖鱼丿ㄋ丨ㄋ	敖鱼丿ㄋ丨ㄋ
阙	门屰丿ㄋ丿丶	门屰丿ㄋ丿丶
毡	毛占丨一丨ㄋ	毛占丨一丨ㄋ
褥	衤辰一丨丶丶	衤辰一丨丶丶
搔	扌双丶丨ㄋ一	扌双丶丨ㄋ一
笋	尹ㄋ一一丿	尹ㄋ一一丿
狞	犬宀一丨丨丨	犬宀一丨丨丨
韶	音刀丨ㄋ一一	音刀丨ㄋ一一
冕	日象丿ㄋㄋㄋ	日象丿ㄋㄋㄋ
骼	骨各丿ㄋ丶丨	骨各丿ㄋ丶丨
蔼	艹讠丨ㄋ一一	艹讠丨ㄋ一一
烹	了丶丶丶丶	了丶丶丶丶
奄	大日ㄋㄋㄋㄋ	大日ㄋㄋㄋㄋ
嫖	女西一一丨丿	女西一一丨丿
沐	氵木一丨丿丶	氵木一丨丿丶
噗	口业丶丿一一	口业丶丿一一
蛟	虫六丿丶丶丶	虫六丿丶丶丶
岑	山令丿丶丶ㄋ	山令丿丶丶ㄋ
弩	奴弓ㄋ一ㄋㄋ	奴弓ㄋ一ㄋㄋ
咏	口笔ㄋㄋ丿丶	口笔ㄋㄋ丿丶
掳	扌虍ㄋ丿丿丿	扌虍ㄋ丿丿丿
捻	扌令丶ㄋ丶丶	扌令丶ㄋ丶丶
圃	口甫一丨ㄋ一	口甫一丨ㄋ一
孚	爪子ㄋ丨一一	爪子ㄋ丨一一
悴	忄亠丿丶丿丶	忄亠丿丶丿丶
呱	口爪丿丿ㄋ丶	口爪丿丿ㄋ丶
诣	讠七丨ㄋ一一	讠七丨ㄋ一一
祁	衤耳ㄋ丨丨丨	衤耳ㄋ丨丨丨
捶	扌垂丿一丨一	扌垂丿一丨一
钠	金内丨ㄋ丿丶	金内丨ㄋ丿丶
袄	衤天丿一丿丶	衤天丿一丿丶
澎	氵壴丿丿丿丿	氵壴丿丿丿丿
氮	气火丶丿丿丶	气火丶丿丿丶
恪	忄各丿ㄋ丶丨	忄各丿ㄋ丶丨
雏	刍隹丿丨丶一	刍隹丿丨丶一
彷	彳方丶一ㄋ丿	彳方丶一ㄋ丿
撮	扌日一丨丨一	扌日一丨丨一
鹦	贝贝ㄋ丿一丿	贝贝ㄋ丿一丿
堰	土匚丨ㄋ一一	土匚丨ㄋ一一
晖	日冖一ㄋ一丨	日冖一ㄋ一丨
犀	尸水丿一一丨	尸水丿一一丨
腑	月广丿丶一丨	月广丿丶一丨
沽	氵古一丨丨ㄋ	氵古一丨丨ㄋ
橄	木㇉一丨丨一	木Z一丨丨一
掐	扌鱼丿丨一ㄋ	扌鱼丿丨一ㄋ
亵	亠执丿ㄋ丿丶	亠执丿ㄋ丿丶
龋	止笔丨ㄋ一丨	止笔丨ㄋ一丨
嗒	口艹丿丶一丨	口艹丿丶一丨
咀	口目丨ㄋ一一	口目丨ㄋ一一
祺	衤其一丨丨一	衤其一丨丨一
锚	金艹丨ㄋ一丨	金艹丨ㄋ一丨
匾	匚户丨ㄋ一丨	匚户丨ㄋ一丨
萃	艹亠丿丶丿丶	艹亠丿丶丿丶
乓	丘笔丶丶丶丶	丘笔丶丶丶丶
贻	贝厶丨ㄋ一一	贝厶丨ㄋ一一
觑	虍业丨ㄋ丿ㄋ	虍业丨ㄋ丿ㄋ
揖	扌口一丨丨一	扌口一丨丨一
憔	忄隹丶丶丶丶	忄隹丶丶丶丶
吝	文口丨ㄋ一一	文口丨ㄋ一一
羌	羊乙ㄋㄋㄋㄋ	羊乙ㄋㄋㄋㄋ
蠕	虫一丿丨ㄋ	虫一丿丨ㄋ
砾	石留丨丿丶丶	石留丨丿丶丶
诲	讠ㄋㄋ丶一	讠ㄋㄋ丶一
肴	乂石丨ㄋ一一	乂石丨ㄋ一一
撩	扌大丶丶丨ㄋ	扌大丶丶丨ㄋ
坍	土冂丶一一一	土冂丶一一一
酥	西禾一丨丿丶	西禾一丨丿丶
袅	鸟衣丶一丿ㄋ	鸟衣丶一丿ㄋ
黝	黑幺ㄋ丿丿丿	黑幺ㄋ丿丿丿
俾	亻卑丿丨ㄋ一	亻卑丿丨ㄋ一
嫣	女正ㄋ一丶丶	女正ㄋ一丶丶
穹	穴弓ㄋ一ㄋㄋ	穴弓ㄋ一ㄋㄋ
秧	禾冂一丿丶丶	禾冂一丿丶丶
妊	女王丿一丨一	女王丿一丨一
溉	氵一ㄋ丿ㄋ	氵一ㄋ丿ㄋ
鹊	共日丿ㄋ丶ㄋ	共日丿ㄋ丶ㄋ
聿	聿ㄋ一一一一	聿ㄋ一一一一
疙	疒ㄋㄋㄋㄋ	疒ㄋㄋㄋㄋ
蘑	艹麻一丿丨ㄋ	艹麻一丿丨ㄋ
睾	笔四一丨一一	笔四一丨一一
楷	木比丿丨ㄋ一	木比丿丨ㄋ一
茹	艹女丨ㄋ一一	艹女丨ㄋ一一
酵	西者ㄋ丨一一	西者ㄋ丨一一
锌	金辛丶一丶丿	金辛丶一丶丿
滇	氵直丿丶丶丶	氵直丿丶丶丶
辗	车尸一丨丨一	车尸一丨丨一
纂	目一丿丶ㄋ	目一丿丶ㄋ
圭	圭一丨一一丨	圭一丨一一丨
幔	巾日丨ㄋ丨丨	巾日丨ㄋ丨丨
褒	亠亻丨ㄋ一一	亠亻丨ㄋ一一
揍	扌丿一丿丶	扌丿一丿丶
倔	亻尸ㄋ丨丨ㄋ	亻尸ㄋ丨丨ㄋ
诽	讠非丨一一一	讠非丨一一一
颉	吉页一丿丨ㄋ	吉页一丿丨ㄋ
腓	月非丨一一一	月非丨一一一
锄	金目ㄋ丿丿丿	金目ㄋ丿丿丿
嗔	口直丿丶丶丶	口直丿丶丶丶
磺	石共丨ㄋ一丨	石共丨ㄋ一丨
攒	扌先丿一丨一	扌先丿一丨一
雳	广ㄋ丿丿丿	广ㄋ丿丿丿
瘩	疒艹丿丶一丨	疒艹丿丶一丨
悚	忄束一丨ㄋ一	忄束一丨ㄋ一
吆	口幺ㄋㄋ丶丶	口幺ㄋㄋ丶丶
墩	土ㄋ丨一丿	土ㄋ丨一丿
彝	彑米ㄋㄋ丶丨	彑米ㄋㄋ丶丨
逍	月丶ㄋ丶丶	月丶ㄋ丶丶
囱	文一一一一	文一一一一
辄	车耳ㄋㄋㄋㄋ	车耳ㄋㄋㄋㄋ
俨	亻亚丿丿丿丿	亻亚丿丿丿丿
桅	木厃ㄋㄋㄋㄋ	木厃ㄋㄋㄋㄋ
纶	纟仑丿丶丿ㄋ	纟仑丿丶丿ㄋ
悸	忄禾ㄋ丨一一	忄禾ㄋ丨一一
殃	歹冂一丿丶丶	歹冂一丿丶丶
帧	巾卜丨ㄋ丿丶	巾卜丨ㄋ丿丶
俐	亻禾丨丨丨丨	亻禾丨丨丨丨
绮	纟大一丨ㄋ一	纟大一丨ㄋ一
袒	衤旦丨ㄋ一一	衤旦丨ㄋ一一
籽	米子ㄋ丨一一	米子ㄋ丨一一
孰	子丿ㄋ丶丶	子丿ㄋ丶丶
愫	忄丰ㄋㄋ丶丨	忄丰ㄋㄋ丶丨
拌	扌半丶丿一一	扌半丶丿一一
橙	木一丨ㄋ一	木祭一丨ㄋ一
暨	旡丨ㄋ一一	旡丨ㄋ一一
敖	敖一一丨一ㄋ	敖一一丨一ㄋ
赘	敖贝丨ㄋ丿丶	敖贝丨ㄋ丿丶
抉	扌匚丿丶丶丶	扌匚丿丶丶丶
剌	束刂丨丨丨丨	束刂丨丨丨丨
娼	女日丨ㄋ一一	女日丨ㄋ一一
淤	氵方丿丶丶丶	氵方丿丶丶丶
顼	王页一丿丨ㄋ	王页一丿丨ㄋ
哝	口农丶ㄋ丿ㄋ	口农丶ㄋ丿ㄋ
葵	艹一一丿丶	艹祭一一丿丶
酣	西甘一丨丨一	西甘一丨丨一
麓	林鹿丶一丿ㄋ	林鹿丶一丿ㄋ
琅	王笔ㄋ一一ㄋ	王笔ㄋ一一ㄋ
钵	金木一一一一	金木一一一一
簸	其ㄋ丿丨ㄋ	其ㄋ丿丨ㄋ
禾	禾一丨丿丶丶	禾一丨丿丶丶
铢	金笔丨丿丶丶	金笔丨丿丶丶
璧	辟王丶丶丶丶	辟王丶丶丶丶
娠	女辰一丿一一	女辰一丿一一
彗	丰丰ㄋ一一一	丰丰ㄋ一一一
惋	忄宀丿ㄋ丶ㄋ	忄宀丿ㄋ丶ㄋ
腋	月亠丿丶丿ㄋ	月亠丿丶丿ㄋ
螂	虫笔ㄋ一一ㄋ	虫笔ㄋ一一ㄋ
阪	耳广ㄋ丶丶丶	耳广ㄋ丶丶丶
掣	巾丨丨丿一	巾丨丨丿一
劾	亥力ㄋ丿丿丿	亥力ㄋ丿丿丿
沥	氵广ㄋ丿丿丿	氵广ㄋ丿丿丿
嚓	口宀丿ㄋ丶丶	口宀丿ㄋ丶丶
粱	氵刀丿丶丶丿	氵刀丿丶丶丿
惮	忄单丶丿丨ㄋ	忄单丶丿丨ㄋ
氖	气乃ㄋ丿丿丿	气乃ㄋ丿丿丿
捎	扌丨ㄋ一一	扌丨ㄋ一一
羔	羊水丶丶丶丶	羊水丶丶丶丶
俟	亻厶丿一一丿	亻厶丿一一丿
渲	氵宀一丨ㄋ一	氵宀一丨ㄋ一
榄	木丨ㄋ丿ㄋ	木丨ㄋ丿ㄋ
茧	艹虫丨ㄋ一丨	艹虫丨ㄋ一丨
霓	鼠丿ㄋㄋㄋ	鼠丿ㄋㄋㄋ
胥	走月丨ㄋ一一	走月丨ㄋ一一
鹉	笔戋丨一丨一	笔戋丨一丨一
橘	木矛丨ㄋ丿丶	木矛丨ㄋ丿丶
琶	王王ㄋ丨一ㄋ	王王ㄋ丨一ㄋ
撬	扌毛丿一一ㄋ	扌毛丿一一ㄋ
拈	扌占丨一丨ㄋ	扌占丨一丨ㄋ
笆	巴ㄋ丨一ㄋ	巴ㄋ丨一ㄋ
痊	疒人一一丨一	疒人一一丨一
亟	了口ㄋ丶一一	了口ㄋ丶一一
渭	氵田丨ㄋ一一	氵田丨ㄋ一一
狙	犬目丨ㄋ一一	犬目丨ㄋ一一
珂	王可一丨ㄋ一	王可一丨ㄋ一
刨	勹巴丨丨丨丨	勹巴丨丨丨丨
蜕	虫𠮦丿ㄋㄋㄋ	虫兑丿ㄋㄋㄋ
谚	讠立一丿丿丿	讠立一丿丿丿
瞟	目西一一丨丿	目西一一丨丿
憧	忄立丨ㄋ一一	忄立丨ㄋ一一
拗	扌幺ㄋ丿丿丿	扌幺ㄋ丿丿丿
馒	食日丨ㄋ丨丨	食日丨ㄋ丨丨
钗	金双丶丶丶丶	金双丶丶丶丶
帚	尹冖丨ㄋ丨丨	尹冖丨ㄋ丨丨
哧	口赤丿丨丿丶	口赤丿丨丿丶
喋	口甘ㄋ一丨丿	口甘ㄋ一丨丿
箫	聿丿丨丿丶	聿丿丨丿丶
刁	㇉笔一一一一	Z笔一一一一
怦	忄平一丶丿一	忄平一丶丿一
缭	纟大丶丶丨ㄋ	纟大丶丶丨ㄋ
迥	冂口丶ㄋ丶丶	冂口丶ㄋ丶丶
湄	氵尸丨ㄋ一一	氵尸丨ㄋ一一
渝	氵亼丨ㄋ一一	氵亼丨ㄋ一一
磐	舟殳一丿丨ㄋ	舟殳一丿丨ㄋ
冗	冖几丿ㄋㄋㄋ	冖几丿ㄋㄋㄋ
闵	门文丶一丿丶	门文丶一丿丶
黏	禾人丨丶一丿	禾人丨丶一丿
噶	口艹丨ㄋ一一	口艹丨ㄋ一一
蕃	艹釆丨ㄋ一丨	艹釆丨ㄋ一丨
驿	马双一一丨丨	马双一一丨丨
弼	弓笔丿丨ㄋ一	弓笔丿丨ㄋ一
淄	氵川丨ㄋ一丨	氵川丨ㄋ一丨
饺	食六丿丶丶丶	食六丿丶丶丶
韬	韦爪丿丨一ㄋ	韦爪丿丨一ㄋ
踞	尸一丨丨ㄋ	尸一丨丨ㄋ
婷	女一丨丨丨	女一丨丨丨
蜒	虫笔丨一丨一	虫笔丨一丨一
唆	口厶丿丶丿ㄋ	口厶丿丶丿ㄋ
偎	亻田一ㄋ丿丶	亻田一ㄋ丿丶
漉	氵鹿丶一丿ㄋ	氵鹿丶一丿ㄋ
榨	木穴丿一丨一	木穴丿一丨一
矜	矛令丿丶丶ㄋ	矛令丿丶丶ㄋ
皈	白广ㄋ丶丶丶	白广ㄋ丶丶丶
碉	石冂一丨一丨	石冂一丨一丨
笈	及丿ㄋ丶丶	及丿ㄋ丶丶
鲨	氵少丿ㄋ丨ㄋ	氵少丿ㄋ丨ㄋ
枷	木加ㄋ丿丨ㄋ	木加ㄋ丿丨ㄋ
蹑	耳ㄋ丶ㄋ丶	耳ㄋ丶ㄋ丶
瀚	氵丿丶ㄋ丶	氵丿丶ㄋ丶
癖	疒辟ㄋ一丿丨	疒辟ㄋ一丿丨
谑	讠虍一ㄋ一一	讠虍一ㄋ一一
酪	西各丿ㄋ丶丨	西各丿ㄋ丶丨
炙	歹火丶丿丿丶	歹火丶丿丿丶
揩	扌比丿丨ㄋ一	扌比丿丨ㄋ一
蜷	虫ㄋㄋㄋㄋ	虫ㄋㄋㄋㄋ
烬	火尺丶丶丶丶	火尺丶丶丶丶
侏	亻笔丨丿丶丶	亻笔丨丿丶丶
凋	冫冂一丨一丨	冫冂一丨一丨
漪	氵犬一丿丶一	氵犬一丿丶一
悻	忄土丶丿一一	忄土丶丿一一
讪	讠山丨ㄋ丨丨	讠山丨ㄋ丨丨
蹋	日ㄋ丶一ㄋ	日ㄋ丶一ㄋ
搐	扌亠ㄋㄋ丶丨	扌亠ㄋㄋ丶丨
碘	石甲丿丶丶丶	石甲丿丶丶丶
帛	白巾丨ㄋ丨丨	白巾丨ㄋ丨丨
诠	讠人一一丨一	讠人一一丨一
碾	石尸一丨丨一	石尸一丨丨一
擂	扌丨ㄋ一丨	扌丨ㄋ一丨
苯	艹木一一一一	艹木一一一一
诃	讠可一丨ㄋ一	讠可一丨ㄋ一
铎	金双一一丨丨	金双一一丨丨
荀	芍日丨ㄋ一一	芍日丨ㄋ一一
戊	戊一丿ㄋ丿丶	戊一丿ㄋ丿丶
驹	马勹丨ㄋ一一	马勹丨ㄋ一一
攫	扌目丨ㄋ一一	扌目丨ㄋ一一
憬	忄日丶一丨ㄋ	忄日丶一丨ㄋ
哽	口更一丨ㄋ一	口更一丨ㄋ一
踵	舌丨ㄋ一一	舌丨ㄋ一一
蟒	虫艹一丿丶丶	虫艹一丿丶丶
漾	氵羊丶ㄋㄋ丿	氵羊丶ㄋㄋ丿
啧	口丰丨ㄋ丿丶	口丰丨ㄋ丿丶
楠	木十丨ㄋ丶丿	木十丨ㄋ丶丿
吮	口厶丿ㄋㄋㄋ	口厶丿ㄋㄋㄋ
氟	气弓丿丨丨丨	气弓丿丨丨丨
怂	从心丶ㄋ丶丶	从心丶ㄋ丶丶
叼	口㇉一一一一	口Z一一一一
漩	氵族ㄋ丨一丿	氵族ㄋ丨一丿
偕	亻比丿丨ㄋ一	亻比丿丨ㄋ一
竣	立厶丿丶丿ㄋ	立厶丿丶丿ㄋ
蹭	曾丶丿丨ㄋ	曾丶丿丨ㄋ
翌	羽立丶一丶丿	羽立丶一丶丿
臆	月音丶ㄋ丶丶	月音丶ㄋ丶丶
挝	扌寸丶ㄋ丶丶	扌寸丶ㄋ丶丶
崽	山田丶ㄋ丶丶	山田丶ㄋ丶丶
绚	纟勹丨ㄋ一一	纟勹丨ㄋ一一
糜	麻米丶丿一丨	麻米丶丿一丨
瘢	疒舟丿ㄋㄋ丶	疒舟丿ㄋㄋ丶
跤	六丿丶丶丶	六丿丶丶丶
阑	门束丶丶丶丶	门束丶丶丶丶
恬	忄舌丿一丨丨	忄舌丿一丨丨
豢	豕一丿ㄋ丿	豕一丿ㄋ丿
跷	尧一ㄋ丿一	尧一ㄋ丿一
汶	氵文丶一丿丶	氵文丶一丿丶
琵	王王一ㄋ丿ㄋ	王王一ㄋ丿ㄋ
憨	㇉耳丿一丿丶	Z耳丿一丿丶
蜗	虫口丨ㄋ丿丶	虫口丨ㄋ丿丶
螅	虫自丶ㄋ丶丶	虫自丶ㄋ丶丶
惴	忄山一丿丨ㄋ	忄山一丿丨ㄋ
戟	戋一ㄋ丿丶	戋一ㄋ丿丶
匮	匚丨ㄋ丿丶	匚丨ㄋ丿丶
恙	羊心丶ㄋ丶丶	羊心丶ㄋ丶丶
桢	木卜丨ㄋ丿丶	木卜丨ㄋ丿丶
抿	扌民ㄋ一ㄋ一	扌民ㄋ一ㄋ一
笺	戋一一ㄋ丿	戋一一ㄋ丿
瞳	目立丨ㄋ一一	目立丨ㄋ一一
蛤	虫合丿丶一丨	虫合丿丶一丨
瓢	西示丿丿ㄋ丶	西示丿丿ㄋ丶
跺	几一丨丿丶	几一丨丿丶
芹	艹丘丿丿一丨	艹丘丿丿一丨
秤	禾平一丶丿一	禾平一丶丿一
潦	氵大丶丶丨ㄋ	氵大丶丶丨ㄋ
哒	口大丶ㄋ丶丶	口大丶ㄋ丶丶
饬	食ㄋ丿丿丿	食ㄋ丿丿丿
栩	木羽ㄋ丶一ㄋ	木羽ㄋ丶一ㄋ
曦	日羊一丨丿丶	日羊一丨丿丶
骷	骨古一丨丨ㄋ	骨古一丨丨ㄋ
鬓	长宀丿丨一丨	长宀丿丨一丨
卤	占乂丿丶丶丶	占乂丿丶丶丶
嫡	女立丨ㄋ一丨	女立丨ㄋ一丨
丕	不笔一一一一	不笔一一一一
梓	木辛丶一丶丿	木辛丶一丶丿
嗖	口鼠丨ㄋ丶丶	口鼠丨ㄋ丶丶
惦	忄广丨一丨ㄋ	忄广丨一丨ㄋ
浚	氵厶丿丶丿ㄋ	氵厶丿丶丿ㄋ
咔	口上丨丶丶丶	口上丨丶丶丶
荃	艹人一一丨一	艹人一一丨一
藐	艹豸丿丨ㄋ一	艹豸丿丨ㄋ一
唧	口ㄋ丨丨丨	口ㄋ丨丨丨
玺	尔王丶丶丶丶	尔王丶丶丶丶
铐	金者一ㄋㄋㄋ	金者一ㄋㄋㄋ
汛	氵乙一丨丨丨	氵乙一丨丨丨
髅	骨米ㄋ丿一一	骨米ㄋ丿一一
渤	氵ㄋ丨一ㄋ	氵ㄋ丨一ㄋ
皿	四丨ㄋ丨丨一	四丨ㄋ丨丨一
箍	扌一ㄋ丨ㄋ	扌一ㄋ丨ㄋ
馅	食鱼丿丨一ㄋ	食鱼丿丨一ㄋ
汾	氵分丿丶ㄋ丿	氵分丿丶ㄋ丿
戍	戊笔丶丶丶丶	戊笔丶丶丶丶
痔	疒土一丨丶丶	疒土一丨丶丶
褶	衤羽丿丨ㄋ一	衤羽丿丨ㄋ一
聆	耳令丿丶丶ㄋ	耳令丿丶丶ㄋ
涎	氵笔丨一丨一	氵笔丨一丨一
汞	工水丨ㄋ丿丶	工水丨ㄋ丿丶
巅	山直丿丶一丿	山直丿丶一丿
渍	氵丰丨ㄋ丿丶	氵丰丨ㄋ丿丶
疣	疒尢丶丶丶丶	疒尢丶丶丶丶
奂	鱼冂一丿丶丶	鱼冂一丿丶丶
傩	亻双丿丨丶一	亻双丿丨丶一
逵	土八一丨一丶	土八一丨一丶
耆	者七丨ㄋ一一	者七丨ㄋ一一
鳄	鱼吅一一ㄋㄋ	鱼吅一一ㄋㄋ
蟋	虫釆丶ㄋ丶丶	虫釆丶ㄋ丶丶
讹	讠化丿丨丿ㄋ	讠化丿丨丿ㄋ
膺	广亻丿丨丶一	广亻丿丨丶一
蹿	穴丨ㄋ一丨	穴丨ㄋ一丨
沂	氵丘丿丿一丨	氵丘丿丿一丨
筏	亻一ㄋ丿丶	亻一ㄋ丿丶
釜	父舌丶丿一一	父舌丶丿一一
坯	土不一一一一	土不一一一一
峦	亦山丨ㄋ丨丨	亦山丨ㄋ丨丨
茬	艹一丨一一	艹一丨一一
摒	扌尸丶丿一一	扌尸丶丿一一
蟀	虫亠ㄋㄋ丶丶	虫亠ㄋㄋ丶丶
撵	扌夫一一丿丶	扌夫一一丿丶
缤	纟宀丿丨一丨	纟宀丿丨一丨
浒	氵讠丿一一丨	氵讠丿一一丨
珑	王龙一丿ㄋ丿	王龙一丿ㄋ丿
嵋	山尸丨ㄋ一一	山尸丨ㄋ一一
苞	芍巴ㄋ一ㄋㄋ	芍巴ㄋ一ㄋㄋ
瑾	王堇一丨丨一	王堇一丨丨一
泵	石水丨ㄋ丿丶	石水丨ㄋ丿丶
暧	日一丿ㄋ丶	日一丿ㄋ丶
钾	金甲丨ㄋ一一	金甲丨ㄋ一一
赓	广尹丿丶丨ㄋ	广尹丿丶丨ㄋ
叟	鼠笔ㄋ丶丶丶	鼠笔ㄋ丶丶丶
佚	亻笔一一丿丶	亻笔一一丿丶
沓	水日丨ㄋ一一	水日丨ㄋ一一
撂	扌田丿ㄋ丶丨	扌田丿ㄋ丶丨
蛊	虫四丨ㄋ丨丨	虫四丨ㄋ丨丨
晏	日宀ㄋ丿一一	日宀ㄋ丿一一
璐	王丿ㄋ丶丨	王丿ㄋ丶丨
甥	生田ㄋ丿丿丿	生田ㄋ丿丿丿
瘪	疒自丿丶丿ㄋ	疒自丿丶丿ㄋ
漳	氵音一丨丨丨	氵音一丨丨丨
阉	门大丨ㄋ一一	门大丨ㄋ一一
蹂	矛一丨丿丶	矛一丨丿丶
琏	王车丶ㄋ丶丶	王车丶ㄋ丶丶
鳃	鱼田丶ㄋ丶丶	鱼田丶ㄋ丶丶
湃	氵手一一一一	氵手一一一一
辘	车鹿丶一丿ㄋ	车鹿丶一丿ㄋ
鼾	自田一一丨丨	自田一一丨丨
躏	艹丶丨ㄋ丿	艹丶丨ㄋ丿
僭	亻旡一ㄋ丿ㄋ	亻旡一ㄋ丿ㄋ
懵	忄萝丶ㄋ丨ㄋ	忄萝丶ㄋ丨ㄋ
褚	衤者一丨一丿	衤者一丨一丿
镰	金广丶丿一ㄋ	金广丶丿一ㄋ
寐	宀片丨丿丶丶	宀片丨丿丶丶
攥	扌丨ㄋ一一	扌丨ㄋ一一
涧	氵门丨ㄋ一一	氵门丨ㄋ一一
蝙	虫户丨ㄋ一丨	虫户丨ㄋ一丨
脐	月文丿丨丨丨	月文丿丨丨丨
辕	车土丨ㄋ一丿	车土丨ㄋ一丿
涣	氵鱼丨ㄋ一丿	氵鱼丨ㄋ一丿
煜	火日丶一丶丿	火日丶一丶丿
骥	马北丨ㄋ一丨	马北丨ㄋ一丨
杞	木巴ㄋ一ㄋㄋ	木巴ㄋ一ㄋㄋ
嗳	口一丿ㄋ丶	口一丿ㄋ丶
祯	衤卜丨ㄋ丿丶	衤卜丨ㄋ丿丶
傣	亻丨丶一丿	亻丨丶一丿
酉	西一丨ㄋ丿ㄋ	西一丨ㄋ丿ㄋ
鑫	金金丿丶一一	金金丿丶一一
瑕	王叚ㄋ一丨一	王叚ㄋ一丨一
捺	扌大一一丨丿	扌大一一丨丿
秸	禾吉一丨一丨	禾吉一丨一丨
馋	食象丿ㄋ丶丶	食象丿ㄋ丶丶
窿	穴耳丿ㄋ丶一	穴耳丿ㄋ丶一
楔	木丰ㄋ丿一丿	木丰ㄋ丿一丿
胱	月光丨丶丿一	月光丨丶丿一
荔	艹力ㄋ丿丿丿	艹力ㄋ丿丿丿
蟆	虫莫一丨丨丨	虫莫一丨丨丨
遐	叚辶丶ㄋ丶丶	叚辶丶ㄋ丶丶
屹	山ㄋㄋㄋㄋ	山ㄋㄋㄋㄋ
湍	氵山一丿丨ㄋ	氵山一丿丨ㄋ
轲	车可一丨ㄋ一	车可一丨ㄋ一
镯	金四丿ㄋ丨ㄋ	金四丿ㄋ丨ㄋ
缰	纟笔丨ㄋ一丨	纟笔丨ㄋ一丨
桦	木化一丨丨丨	木化一丨丨丨
炖	火屯一ㄋ丨ㄋ	火屯一ㄋ丨ㄋ
啬	十䒑丨ㄋ丨ㄋ	十首丨ㄋ丨ㄋ
诩	讠羽ㄋ丶一ㄋ	讠羽ㄋ丶一ㄋ
羚	羊令丿丶丶ㄋ	羊令丿丶丶ㄋ
钡	气贝丨ㄋ丿丶	气贝丨ㄋ丿丶
绯	纟非丨一一一	纟非丨一一一
掖	扌亠丿丶丿ㄋ	扌亠丿丶丿ㄋ
箓	尹丨ㄋ丿丶	尹丨ㄋ丿丶
涸	氵口一丨丨ㄋ	氵口一丨丨ㄋ
鸳	歹巴丿ㄋ丶ㄋ	歹巴丿ㄋ丶ㄋ
塾	子丿ㄋ丶一	子丿ㄋ丶一
呸	口不一一一一	口不一一一一
抡	扌仑丿丶丿ㄋ	扌仑丿丶丿ㄋ
熹	壴口丶丶丶丶	壴口丶丶丶丶
擞	扌米ㄋ丿一丿	扌米ㄋ丿一丿
坷	土可一丨ㄋ一	土可一丨ㄋ一
筵	笔丨一丨一	笔丨一丨一
嗟	口羊一丨一一	口羊一丨一一
瓮	公瓦一ㄋㄋ丶	公瓦一ㄋㄋ丶
跛	皮ㄋ丿丨ㄋ	皮ㄋ丿丨ㄋ
亘	笔旦丨ㄋ一一	笔旦丨ㄋ一一
汕	氵山丨ㄋ丨丨	氵山丨ㄋ丨丨
欤	与笔丿ㄋ丿丶	与笔丿ㄋ丿丶
壑	卜冖一丿丶丿	卜冖一丿丶丿
颍	七水一丿丨ㄋ	七水一丿丨ㄋ
姗	女冂丨ㄋ一一	女冂丨ㄋ一一
溥	氵甫一丨丶丶	氵甫一丨丶丶
踊	甬ㄋ丶丨ㄋ	甬ㄋ丶丨ㄋ
枭	鸟木一丨丿丶	鸟木一丨丿丶
暄	日宀一丨ㄋ一	日宀一丨ㄋ一
稷	禾田丿丶丿ㄋ	禾田丿丶丿ㄋ
跚	冂丨ㄋ一一	冂丨ㄋ一一
笙	生丿一一丨	生丿一一丨
涟	氵车丶ㄋ丶丶	氵车丶ㄋ丶丶
瀛	氵赢ㄋ丿一一	氵赢ㄋ丿一一
滕	月丨丶一丿	月丨丶一丿
踝	日一丨丿丶	日一丨丿丶
贰	戋二丨ㄋ丿丶	戋二丨ㄋ丿丶
瞰	目㇉一丨丨一	目Z一丨丨一
恻	忄贝丨丨丨丨	忄贝丨丨丨丨
嚏	口丨ㄋ一丨	口丨ㄋ一丨
迢	刀口丶ㄋ丶丶	刀口丶ㄋ丶丶
獗	犬广丶丿一ㄋ	犬广丶丿一ㄋ
睑	目亼丶丶丿一	目亼丶丶丿一
邯	甘耳ㄋ丨丨丨	甘耳ㄋ丨丨丨
萦	萝糸ㄋㄋ丶丨	萝糸ㄋㄋ丶丨
赡	贝厃丿丶丶一	贝厃丿丶丶一
珥	王耳一丨丨一	王耳一丨丨一
酮	西冂一丨ㄋ一	西冂一丨ㄋ一
璞	王业丶丿一一	王业丶丿一一
羹	羊水丶丿一一	羊水丶丿一一
缄	纟戊一丨ㄋ一	纟戊一丨ㄋ一
鸾	亦鸟丿ㄋ丶ㄋ	亦鸟丿ㄋ丶ㄋ
俸	亻一一丨丨	亻一一丨丨
晾	日京丶一丨ㄋ	日京丶一丨ㄋ
媲	女丿丶一一	女丿丶一一
蜿	虫宀丿ㄋ丶ㄋ	虫宀丿ㄋ丶ㄋ
恿	甬心丶ㄋ丶丶	甬心丶ㄋ丶丶
讷	讠内丨ㄋ丿丶	讠内丨ㄋ丿丶
扈	户口ㄋ丨一ㄋ	户口ㄋ丨一ㄋ
蜈	虫口一一丿丶	虫口一一丿丶
犊	牛十ㄋ丶丶一	牛十ㄋ丶丶一
蓓	荷立丨ㄋ一一	荷立丨ㄋ一一
翟	羽隹丿丨丶一	羽隹丿丨丶一
藕	艹未丨ㄋ一一	艹未丨ㄋ一一
戌	戊笔一一一一	戊笔一一一一
鋆	土勹丶一丿丶	土勹丶一丿丶
谩	讠日丨ㄋ丨丨	讠日丨ㄋ丨丨
谀	讠鼠丿丶丶丶	讠鼠丿丶丶丶
岐	山十ㄋ丶丶丶	山十ㄋ丶丶丶
卯	留丿ㄋ丿ㄋ丨	留丿ㄋ丿ㄋ丨
谙	讠音丶一丶丿	讠音丶一丶丿
蝎	虫日丿ㄋ丿丶	虫日丿ㄋ丿丶
荼	艹亼一丨丿丶	艹亼一丨丿丶
甄	西土一ㄋㄋ丶	西土一ㄋㄋ丶
镀	金度ㄋ丶丶丶	金度ㄋ丶丶丶
蟾	虫厃丿丶丶一	虫厃丿丶丶一
椰	木耳ㄋ丨丨丨	木耳ㄋ丨丨丨
蹊	爪ㄋㄋ丶一	爪ㄋㄋ丶一
泞	氵宀一丨丨丨	氵宀一丨丨丨
螃	虫立丶一ㄋ丿	虫立丶一ㄋ丿
撸	扌鱼丨ㄋ一一	扌鱼丨ㄋ一一
檬	木萝一一丿ㄋ	木萝一一丿ㄋ
猓	犬日一丨丿丶	犬日一丨丿丶
蔷	艹十丶丿一丨	艹十丶丿一丨
羲	羊禾一ㄋ一ㄋ	羊禾一ㄋ一ㄋ
瘸	疒加丨ㄋ丿丶	疒加丨ㄋ丿丶
蘸	艹西丿丨丶一	艹西丿丨丶一
蔗	艹度丶丶丶丶	艹度丶丶丶丶
傀	亻鬼丿丨ㄋ一	亻鬼丿丨ㄋ一
锢	金口一丨丨ㄋ	金口一丨丨ㄋ
蚌	虫丰一一一丨	虫丰一一一丨
邃	穴冫一丿ㄋ丿	穴冫一丿ㄋ丿
遽	虍豕丶ㄋ丶丶	虍豕丶ㄋ丶丶
恚	圭心丶ㄋ丶丶	圭心丶ㄋ丶丶
簌	束丿ㄋ丿丶	束丿ㄋ丿丶
锵	金北丿ㄋ丶一	金北丿ㄋ丶一
皑	白山ㄋ一ㄋㄋ	白山ㄋ一ㄋㄋ
昊	日天一一丿丶	日天一一丿丶
焙	火立丨ㄋ一一	火立丨ㄋ一一
鹳	艹吅丿丨丶一	艹吅丿丨丶一
睽	目一一丿丶	目祭一一丿丶
刽	人云丨丨丨丨	人云丨丨丨丨
寰	宀四一丨ㄋ一	宀四一丨ㄋ一
噎	口一丨ㄋ一	口一丨ㄋ一
呗	口贝丨ㄋ丿丶	口贝丨ㄋ丿丶
鳖	米文丿ㄋ丨ㄋ	米文丿ㄋ丨ㄋ
殡	歹宀丿丨一丨	歹宀丿丨一丨
唷	口亡丨ㄋ一一	口亡丨ㄋ一一
恣	次心丶ㄋ丶丶	次心丶ㄋ丶丶
睐	目夹丨丿丶丶	目夹丨丿丶丶
诰	讠告丿一丨一	讠告丿一丨一
淖	氵卜丨ㄋ一一	氵卜丨ㄋ一一
婵	女单丶丿丨ㄋ	女单丶丿丨ㄋ
榈	木门丨ㄋ一丨	木门丨ㄋ一丨
氦	气亥丶一ㄋ丿	气亥丶一ㄋ丿
靳	革丘丿丿一丨	革丘丿丿一丨
蛹	虫甬ㄋ丶丨ㄋ	虫甬ㄋ丶丨ㄋ
蹙	戊上丨丿丶丨	戊上丨丿丶丨
鸯	冂大丿ㄋ丶ㄋ	冂大丿ㄋ丶ㄋ
惬	忄匚一丶丿一	忄匚一丶丿一
罡	四正一丨一丨	四正一丨一丨
眈	目冖丿ㄋㄋㄋ	目冖丿ㄋㄋㄋ
诙	讠石丶丿丿丶	讠石丶丿丿丶
胤	笔幺丨ㄋ一一	笔幺丨ㄋ一一
缮	纟羊丶丿一丨	纟羊丶丿一丨
皋	白大一丨丨丨	白大一丨丨丨
蛀	虫主丶一一丨	虫主丶一一丨
偌	亻艹一丿丨ㄋ	亻艹一丿丨ㄋ
绛	纟文丿ㄋ丶丶	纟文丿ㄋ丶丶
疵	疒此丨一丨一	疒此丨一丨一
葆	荷呆丨ㄋ一一	荷呆丨ㄋ一一
黔	黑令丿丶丶ㄋ	黑令丿丶丶ㄋ
喙	口彑丿ㄋ丿丿	口彑丿ㄋ丿丿
儡	亻田丨ㄋ一丨	亻田丨ㄋ一丨
烽	火文一一一丨	火文一一一丨
佼	亻六丿丶丶丶	亻六丿丶丶丶
斓	文门一丨ㄋ一	文门一丨ㄋ一
颚	吅二ㄋ一丿丨	吅二ㄋ一丿丨
嫔	女宀丿丨一丨	女宀丿丨一丨
龈	止艮ㄋ一一ㄋ	止艮ㄋ一一ㄋ
盅	中四丨ㄋ丨丨	中四丨ㄋ丨丨
娓	女尸丿一一ㄋ	女尸丿一一ㄋ
坂	土广ㄋ丶丶丶	土广ㄋ丶丶丶
町	田于一丨丨丨	田于一丨丨丨
芥	艹人丿丨丨丨	艹人丿丨丨丨
瘠	疒水丿丶丨ㄋ	疒水丿丶丨ㄋ
啜	口双ㄋ丶ㄋ丶	口双ㄋ丶ㄋ丶
橇	木毛丿一一ㄋ	木毛丿一一ㄋ
荟	艹人一一ㄋ丶	艹人一一ㄋ丶
挎	扌大一一ㄋㄋ	扌大一一ㄋㄋ
阂	门亥丶一ㄋ丿	门亥丶一ㄋ丿
淇	氵其一丨丨一	氵其一丨丨一
垛	土几一丨丿丶	土几一丨丿丶
瓒	王先丿一丨一	王先丿一丨一
篓	米ㄋ丿一一	米ㄋ丿一一
虱	乙笔丨ㄋ一丨	乙笔丨ㄋ一丨
跻	文丿丨丨丨	文丿丨丨丨
髯	长冂一丨一一	长冂一丨一一
龛	合龙一丿ㄋ丿	合龙一丿ㄋ丿
蹒	艹一丨ㄋ丿	艹一丨ㄋ丿
瞠	目一丨一一	目一丨一一
痫	疒门一丨丿丶	疒门一丨丿丶
掂	扌广丨一丨ㄋ	扌广丨一丨ㄋ
酰	西先丿一丨一	西先丿一丨一
潼	氵立丨ㄋ一一	氵立丨ㄋ一一
镁	金羊一丿丶丶	金羊一丿丶丶
筱	亻丨丿一丿	亻丨丿一丿
腆	月甲丿丶丶丶	月甲丿丶丶丶
灸	久火丶丿丿丶	久火丶丿丿丶
谆	讠ㄋ丨一一	讠ㄋ丨一一
茗	艹歹丨ㄋ一一	艹歹丨ㄋ一一
骋	马甲一ㄋㄋㄋ	马甲一ㄋㄋㄋ
壬	王丿一丨一一	王丿一丨一一
椋	木京丶一丨ㄋ	木京丶一丨ㄋ
蛔	虫回丨ㄋ丨ㄋ	虫回丨ㄋ丨ㄋ
潺	氵尸ㄋ丨一一	氵尸ㄋ丨一一
扉	户非丨一一一	户非丨一一一
耘	未云一一ㄋ丶	未云一一ㄋ丶
槟	木宀丿丨一丨	木宀丿丨一丨
甬	甬ㄋ丶丨ㄋ一	甬ㄋ丶丨ㄋ一
雹	勹ㄋ一ㄋㄋ	勹ㄋ一ㄋㄋ
淞	氵木丿丶ㄋ丶	氵木丿丶ㄋ丶
谥	讠䒑丿丶丨ㄋ	讠首丿丶丨ㄋ
蕙	艹笔丨ㄋ一一	艹笔丨ㄋ一一
燎	火大丶丶丨ㄋ	火大丶丶丨ㄋ
蚪	虫冫一丨丨丨	虫冫一丨丨丨
蜻	虫青一一丨一	虫青一一丨一
轶	车笔一一丿丶	车笔一一丿丶
郸	单耳ㄋ丨丨丨	单耳ㄋ丨丨丨
楣	木尸丨ㄋ一一	木尸丨ㄋ一一
狰	犬争丿ㄋㄋ一	犬争丿ㄋㄋ一
荪	艹子丨丿丶丶	艹子丨丿丶丶
捋	扌爪一丨丶丶	扌爪一丨丶丶
涓	氵口丨ㄋ一一	氵口丨ㄋ一一
娄	米女ㄋ丿一一	米女ㄋ丿一一
麝	鹿身一丨丶丶	鹿身一丨丶丶
薰	艹舌丨ㄋ丶丿	艹舌丨ㄋ丶丿
蚤	双笔丨ㄋ一丨	双笔丨ㄋ一丨
醮	西隹丶丶丶丶	西隹丶丶丶丶
搪	扌广ㄋ一一丨	扌广ㄋ一一丨
瞌	目去丨ㄋ丨丨	目去丨ㄋ丨丨
谧	讠心丿丨ㄋ丨	讠心丿丨ㄋ丨
湮	氵西一丨一一	氵西一丨一一
辍	车双ㄋ丶ㄋ丶	车双ㄋ丶ㄋ丶
茉	艹未丨丿丶丶	艹未丨丿丶丶
樟	木音一丨丨丨	木音一丨丨丨
梆	木丰ㄋ丨丨丨	木丰ㄋ丨丨丨
岖	山区一丿丶ㄋ	山区一丿丶ㄋ
臼	鼠丿丨一ㄋ一	鼠丿丨一ㄋ一
癣	疒鱼丶丿一一	疒鱼丶丿一一
穑	禾十丶丿一丨	禾十丶丿一丨
玷	王占丨一丨ㄋ	王占丨一丨ㄋ
馍	食莫一丨丨丨	食莫一丨丨丨
呷	口甲丨ㄋ一一	口甲丨ㄋ一一
妩	女笔一丿ㄋㄋ	女笔一丿ㄋㄋ
萼	艹吅一一ㄋㄋ	艹吅一一ㄋㄋ
伫	亻宀一一一一	亻宀一一一一
彤	冂亠丿丿丿丿	冂亠丿丿丿丿
媛	女爪一一丿ㄋ	女爪一一丿ㄋ
莓	艹ㄋㄋ丶一	艹ㄋㄋ丶一
岬	山甲丨ㄋ一一	山甲丨ㄋ一一
惆	忄冂一丨一丨	忄冂一丨一丨
鳎	鱼日ㄋ丶一ㄋ	鱼日ㄋ丶一ㄋ
囔	口丨ㄋ一丨	口丨ㄋ一丨
啾	口禾丶丿丿丶	口禾丶丿丿丶
蜓	虫王ㄋ丶丶丶	虫王ㄋ丶丶丶
孺	子一丿丨ㄋ	子一丿丨ㄋ
徇	彳勹丨ㄋ一一	彳勹丨ㄋ一一
徵	王丿一丨一	王丿一丨一
焊	火日一一丨丨	火日一一丨丨
昵	日尸丿ㄋㄋㄋ	日尸丿ㄋㄋㄋ
岱	代山丨ㄋ丨丨	代山丨ㄋ丨丨
飙	犬犬一丿丶丶	犬犬一丿丶丶
卅	笔川丿丨丨丨	笔川丿丨丨丨
邙	亡耳ㄋ丨丨丨	亡耳ㄋ丨丨丨
痞	疒不丨ㄋ一一	疒不丨ㄋ一一
隼	隹十一丨丨丨	隹十一丨丨丨
恫	忄冂一丨ㄋ一	忄冂一丨ㄋ一
桀	歹㐄一丨丿丶	歹年一丨丿丶
怆	忄人ㄋㄋㄋㄋ	忄人ㄋㄋㄋㄋ
绶	纟ㄋ丶丶丶	纟ㄋ丶丶丶
裆	衤ㄋ一一一	衤ㄋ一一一
盂	于四丨ㄋ丨丨	于四丨ㄋ丨丨
桧	木人一一ㄋ丶	木人一一ㄋ丶
蚓	虫弓丨丨丨丨	虫弓丨丨丨丨
嗷	口敖一一丨一	口敖一一丨一
槌	木笔丨ㄋ一ㄋ	木笔丨ㄋ一ㄋ
抠	扌区一丿丶ㄋ	扌区一丿丶ㄋ
芮	艹内丨ㄋ丿丶	艹内丨ㄋ丿丶
蚣	虫公丿丶ㄋ丶	虫公丿丶ㄋ丶
痘	疒豆一丨ㄋ一	疒豆一丨ㄋ一
痢	疒禾丨丨丨丨	疒禾丨丨丨丨
铿	金一丨一一	金一丨一一
闩	门笔一一一一	门笔一一一一
飓	几乂一ㄋ一一	几乂一ㄋ一一
蝌	虫禾丶丶一丨	虫禾丶丶一丨
疱	疒勹ㄋ一ㄋㄋ	疒勹ㄋ一ㄋㄋ
撅	扌广丶丿一ㄋ	扌广丶丿一ㄋ
蚯	虫丘丿丨一丨	虫丘丿丨一丨
窠	穴日一丨丿丶	穴日一丨丿丶
斡	人丶丶一丨	人丶丶一丨
荚	艹夹丿丶丶丶	艹夹丿丶丶丶
耷	大耳一丨丨一	大耳一丨丨一
砚	石见丨ㄋ丿ㄋ	石见丨ㄋ丿ㄋ
牒	片甘ㄋ一丨丿	片甘ㄋ一丨丿
煦	日勹丨ㄋ一丶	日勹丨ㄋ一丶
赈	贝辰一丿一一	贝辰一丿一一
嗫	口耳ㄋ丶ㄋ丶	口耳ㄋ丶ㄋ丶
耙	未巴ㄋ丨一ㄋ	未巴ㄋ丨一ㄋ
榕	木穴丿丶丨ㄋ	木穴丿丶丨ㄋ
鞑	革大丶ㄋ丶丶	革大丶ㄋ丶丶
醺	西舌丨ㄋ丶丿	西舌丨ㄋ丶丿
袤	亠矛丿ㄋ丿丶	亠矛丿ㄋ丿丶
谌	讠其ㄋㄋㄋㄋ	讠其ㄋㄋㄋㄋ
秆	禾舌一一丨丨	禾舌一一丨丨
翡	非羽ㄋ丶一ㄋ	非羽ㄋ丶一ㄋ
徨	彳白一一丨一	彳白一一丨一
橹	木鱼丨ㄋ一一	木鱼丨ㄋ一一
缨	纟贝丨ㄋ丿丶	纟贝丨ㄋ丿丶
锹	金禾丶丿丿丶	金禾丶丿丿丶
嵇	禾尢丶丨ㄋ丨	禾尢丶丨ㄋ丨
圪	土ㄋㄋㄋㄋ	土ㄋㄋㄋㄋ
髻	长吉一丨一丨	长吉一丨一丨
嗬	口艹丿丶一丨	口艹丿丶一丨
痣	疒土丶ㄋ丶丶	疒土丶ㄋ丶丶
辎	车川丨ㄋ一丨	车川丨ㄋ一丨
谄	讠鱼丿丨一ㄋ	讠鱼丿丨一ㄋ
娩	女象丿ㄋㄋㄋ	女象丿ㄋㄋㄋ
蛐	虫甲丨ㄋ一丨	虫甲丨ㄋ一丨
鹞	爪缶丿ㄋ丶ㄋ	爪缶丿ㄋ丶ㄋ
翱	白大一丨ㄋ丶	白大一丨ㄋ丶
庖	广勹ㄋ一ㄋㄋ	广勹ㄋ一ㄋㄋ
籁	束丿ㄋ丨ㄋ	束丿ㄋ丨ㄋ
鳗	鱼日丨ㄋ丨丨	鱼日丨ㄋ丨丨
蓿	艹宀丿丶一丿	艹宀丿丶一丿
疟	疒尹一ㄋ一一	疒尹一ㄋ一一
鲇	鱼占丨一丨ㄋ	鱼占丨一丨ㄋ
颔	令口一丿丨ㄋ	令口一丿丨ㄋ
黠	黑吉一丨一丨	黑吉一丨一丨
嚅	口一丿丨ㄋ	口一丿丨ㄋ
瘀	疒方丿丶丶丶	疒方丿丶丶丶
黜	黑山ㄋ丨丨丨	黑山ㄋ丨丨丨
濑	氵束丿ㄋ丨ㄋ	氵束丿ㄋ丨ㄋ
忐	上心丶ㄋ丶丶	上心丶ㄋ丶丶
馁	食爪ㄋ丿一一	食爪ㄋ丿一一
洵	氵勹丨ㄋ一一	氵勹丨ㄋ一一
忑	下心丶ㄋ丶丶	下心丶ㄋ丶丶
砥	石氏丶丶丶丶	石氏丶丶丶丶
咂	口匚丨ㄋ丨丨	口匚丨ㄋ丨丨
罹	四忄丿丨丶一	四忄丿丨丶一
糠	米广ㄋ一一丨	米广ㄋ一一丨
偃	亻匚丨ㄋ一一	亻匚丨ㄋ一一
匝	匚巾丨ㄋ丨丨	匚巾丨ㄋ丨丨
淙	氵宀一一丨丿	氵宀一一丨丿
喏	口艹一丿丨ㄋ	口艹一丿丨ㄋ
纫	纟刀丶丶丶丶	纟刀丶丶丶丶
闾	门口丨ㄋ一一	门口丨ㄋ一一
祛	衤去一丨一ㄋ	衤去一丨一ㄋ
腼	月面一丿丨ㄋ	月面一丿丨ㄋ
蛰	执虫丨ㄋ一丨	执虫丨ㄋ一丨
曜	日羽丿丨丶一	日羽丿丨丶一
涝	氵萝ㄋ丿丿丿	氵萝ㄋ丿丿丿
厩	广一ㄋ丿ㄋ	广一ㄋ丿ㄋ
闰	门王一一丨一	门王一一丨一
疽	疒目丨ㄋ一一	疒目丨ㄋ一一
煊	火宀一丨ㄋ一	火宀一丨ㄋ一
洄	氵回丨ㄋ丨ㄋ	氵回丨ㄋ丨ㄋ
璜	王共丨ㄋ一丨	王共丨ㄋ一丨
藓	艹鱼丶丿一一	艹鱼丶丿一一
汐	氵歹丿ㄋ丶丶	氵歹丿ㄋ丶丶
铬	金各丿ㄋ丶丨	金各丿ㄋ丶丨
渥	氵尸一ㄋ丶一	氵尸一ㄋ丶一
靼	革旦丨ㄋ一一	革旦丨ㄋ一一
噤	口林一一丨丿	口林一一丨丿
苓	艹令丿丶丶ㄋ	艹令丿丶丶ㄋ
酗	西乂ㄋ丨丨丨	西乂ㄋ丨丨丨
咫	尺口丿丶丶丶	尺口丿丶丶丶
椿	木丨ㄋ一一	木丨ㄋ一一
鲫	鱼ㄋ丨丨丨	鱼ㄋ丨丨丨
锭	金定丶丶ㄋ一	金定丶丶ㄋ一
锺	金舌丨ㄋ一一	金舌丨ㄋ一一
罔	冂䒑丶一ㄋㄋ	冂首丶一ㄋㄋ
匍	勹甫一丨ㄋ一	勹甫一丨ㄋ一
祗	衤氏丶丶丶丶	衤氏丶丶丶丶
锰	金子丨ㄋ丨丨	金子丨ㄋ丨丨
岌	山及丿ㄋ丶丶	山及丿ㄋ丶丶
馀	食亼一丨丿丶	食亼一丨丿丶
畹	田宀丿ㄋ丶ㄋ	田宀丿ㄋ丶ㄋ
熠	火羽丿丨ㄋ一	火羽丿丨ㄋ一
胫	月轻ㄋ丶一丨	月轻ㄋ丶一丨
銮	亦金丿丶一一	亦金丿丶一一
糯	米一丿丨ㄋ	米一丿丨ㄋ
沅	氵元一一丿ㄋ	氵元一一丿ㄋ
棣	木尹丨丶一丿	木尹丨丶一丿
旌	族生丿一一丨	族生丿一一丨
孢	子勹ㄋ一ㄋㄋ	子勹ㄋ一ㄋㄋ
豌	豆宀丿ㄋ丶ㄋ	豆宀丿ㄋ丶ㄋ
盹	目屯一ㄋ丨ㄋ	目屯一ㄋ丨ㄋ
驸	马亻一丨丶丶	马亻一丨丶丶
腌	月大丨ㄋ一一	月大丨ㄋ一一
熵	火立丨ㄋ丿丶	火立丨ㄋ丿丶
镭	金丨ㄋ一丨	金丨ㄋ一丨
镐	金丨ㄋ一一	金丨ㄋ一一
馐	食羊ㄋ丨一一	食羊ㄋ丨一一
癞	疒束丿ㄋ丨ㄋ	疒束丿ㄋ丨ㄋ
骰	骨殳丿ㄋㄋ丶	骨殳丿ㄋㄋ丶
嘤	口贝丨ㄋ丿丶	口贝丨ㄋ丿丶
阖	门去丨ㄋ丨丨	门去丨ㄋ丨丨
瞑	目冖丨ㄋ一一	目冖丨ㄋ一一
韭	非笔一一一一	非笔一一一一
裨	衤卑丿丨ㄋ一	衤卑丿丨ㄋ一
戾	户犬一丿丶丶	户犬一丿丶丶
宕	宀石一丿丨ㄋ	宀石一丿丨ㄋ
镌	金隹ㄋ丿丿丿	金隹ㄋ丿丿丿
溟	氵冖丨ㄋ一一	氵冖丨ㄋ一一
隽	隹乃ㄋ丿丿丿	隹乃ㄋ丿丿丿
牍	片十ㄋ丶丶一	片十ㄋ丶丶一
婊	女丰丿ㄋ丿丶	女丰丿ㄋ丿丶
鹄	告鸟丿ㄋ丶ㄋ	告鸟丿ㄋ丶ㄋ
拄	扌主丶一一丨	扌主丶一一丨
埂	土更一丨ㄋ一	土更一丨ㄋ一
虬	虫乙ㄋㄋㄋㄋ	虫乙ㄋㄋㄋㄋ
娲	女口丨ㄋ丿丶	女口丨ㄋ丿丶
萱	艹宀一丨ㄋ一	艹宀一丨ㄋ一
蠡	彑豕丨ㄋ一丨	彑豕丨ㄋ一丨
啵	口氵ㄋ丿丨ㄋ	口氵ㄋ丿丨ㄋ
芋	艹于一一丨丨	艹于一一丨丨
胭	月因丨ㄋ一丿	月因丨ㄋ一丿
豺	豸㇉一丨丿丿	豸Z一丨丿丿
褛	衤米ㄋ丿一一	衤米ㄋ丿一一
啻	立巾丨ㄋ一一	立巾丨ㄋ一一
蛆	虫目丨ㄋ一一	虫目丨ㄋ一一
柠	木宀一丨丨丨	木宀一丨丨丨
掰	手分丿一一丨	手分丿一一丨
篆	彑丿ㄋ丿丿	彑丿ㄋ丿丿
咛	口宀一丨丨丨	口宀一丨丨丨
倌	亻宀丨ㄋ一ㄋ	亻宀丨ㄋ一ㄋ
蛭	虫至一ㄋ丶一	虫至一ㄋ丶一
莞	艹宀一一丿ㄋ	艹宀一一丿ㄋ
澹	氵厃丿丶丶一	氵厃丿丶丶一
纭	纟云一一ㄋ丶	纟云一一ㄋ丶
谡	讠田丿丶丿ㄋ	讠田丿丶丿ㄋ
荨	艹尹一丨丶丶	艹尹一丨丶丶
潞	氵丿ㄋ丶丨	氵丿ㄋ丶丨
郅	至耳ㄋ丨丨丨	至耳ㄋ丨丨丨
飕	几乂丿丨一ㄋ	几乂丿丨一ㄋ
螳	虫一丨一一	虫一丨一一
弋	戋一ㄋ丶丶丶	戋一ㄋ丶丶丶
胄	甲月丨ㄋ一一	甲月丨ㄋ一一
蟑	虫音一丨丨丨	虫音一丨丨丨
猥	犬田一ㄋ丿丶	犬田一ㄋ丿丶
蟠	虫釆丨ㄋ一丨	虫釆丨ㄋ一丨
昙	日云一一ㄋ丶	日云一一ㄋ丶
宓	宀心丿丿丿丿	宀心丿丿丿丿
锏	金门丨ㄋ一一	金门丨ㄋ一一
烯	火乂丨ㄋ丨丨	火乂丨ㄋ丨丨
濮	氵亻丨丨丶丿	氵亻丨丨丶丿
柑	木甘一丨丨一	木甘一丨丨一
匐	勹鬲丨ㄋ一丨	勹鬲丨ㄋ一丨
蟮	虫羊丶丿一丨	虫羊丶丿一丨
仄	广人丿丶丶丶	广人丿丶丶丶
粼	米歹一ㄋ丨ㄋ	米歹一ㄋ丨ㄋ
蜃	辰虫丨ㄋ一丨	辰虫丨ㄋ一丨
箴	戊一丨ㄋ一	戊一丨ㄋ一
偈	亻日丿ㄋ丿丶	亻日丿ㄋ丿丶
祐	衤石丨ㄋ一一	衤石丨ㄋ一一
嗥	口白一丿丶一	口白一丿丶一
褴	衤丨ㄋ丨丨	衤丨ㄋ丨丨
蕨	艹广丶丿一ㄋ	艹广丶丿一ㄋ
圩	土于一一丨丨	土于一一丨丨
蓟	艹鱼丨丨丨丨	艹鱼丨丨丨丨
杳	木日丨ㄋ一一	木日丨ㄋ一一
魇	广犬丿丨ㄋ一	广犬丿丨ㄋ一
孪	亦子ㄋ丨一一	亦子ㄋ丨一一
簪	旡一ㄋ丿ㄋ	旡一ㄋ丿ㄋ
荤	萝车一ㄋ一丨	萝车一ㄋ一丨
诿	讠禾ㄋ丿一一	讠禾ㄋ丿一一
氲	气日丨ㄋ丨丨	气日丨ㄋ丨丨
飒	立几丿丶丶丶	立几丿丶丶丶
镂	金米ㄋ丿一一	金米ㄋ丿一一
摞	扌田ㄋㄋ丶丨	扌田ㄋㄋ丶丨
夙	几歹一丿ㄋ丶	几歹一丿ㄋ丶
舀	爪鼠丿丨一ㄋ	爪鼠丿丨一ㄋ
臧	戊片一丨ㄋ一	戊片一丨ㄋ一
貂	豸刀丨ㄋ一一	豸刀丨ㄋ一一
蒿	艹丨ㄋ一一	艹丨ㄋ一一
蜥	虫木丿丿一丨	虫木丿丿一丨
蹩	米文丨ㄋ一丨	米文丨ㄋ一丨
噼	口辟ㄋ一丿丨	口辟ㄋ一丿丨
钛	金大丶丶丶丶	金大丶丶丶丶
钚	金不一丿丨丶	金不一丿丨丶
铠	金山ㄋ一ㄋㄋ	金山ㄋ一ㄋㄋ
霭	讠丨ㄋ一一	讠丨ㄋ一一
皙	木丘丿丨ㄋ一	木丘丿丨ㄋ一
濂	氵广丶丿一ㄋ	氵广丶丿一ㄋ
鲈	鱼卜ㄋ一丿丿	鱼卜ㄋ一丿丿
獾	犬艹丨ㄋ一丨	犬艹丨ㄋ一丨
霾	豸丨ㄋ一一	豸丨ㄋ一一
叵	匚口丨ㄋ一一	匚口丨ㄋ一一
泯	氵民ㄋ一ㄋ一	氵民ㄋ一ㄋ一
碴	石木丨ㄋ一一	石木丨ㄋ一一
鸵	鸟宀丿ㄋㄋㄋ	鸟宀丿ㄋㄋㄋ
峪	山八丿丶丨ㄋ	山八丿丶丨ㄋ
饕	口丂丨一ㄋ丿	口丂丨一ㄋ丿
瘁	疒亠丿丶丿丶	疒亠丿丶丿丶
睢	目隹丿丨丶一	目隹丿丨丶一
鬃	长宀一一丨丿	长宀一一丨丿
纣	纟寸一丨丶丶	纟寸一丨丶丶
迩	尔辶丶ㄋ丶丶	尔辶丶ㄋ丶丶
夔	䒑自丨一丨一	首自丨一丨一
榭	木身一丨丶丶	木身一丨丶丶
垠	土艮ㄋ一一ㄋ	土艮ㄋ一一ㄋ
饨	食屯一ㄋ丨ㄋ	食屯一ㄋ丨ㄋ
篝	共丨ㄋ一丨	共丨ㄋ一丨
娑	氵少ㄋ丿一一	氵少ㄋ丿一一
隍	耳白一一丨一	耳白一一丨一
榔	木笔ㄋ一一ㄋ	木笔ㄋ一一ㄋ
浜	氵丘丿丶丶丶	氵丘丿丶丶丶
鲑	鱼圭一丨一一	鱼圭一丨一一
洌	氵歹丨丨丨丨	氵歹丨丨丨丨
浣	氵宀一一丿ㄋ	氵宀一一丿ㄋ
汩	氵口一一一一	氵口一一一一
舐	舌氏丿ㄋ一ㄋ	舌氏丿ㄋ一ㄋ
谔	讠吅一一ㄋㄋ	讠吅一一ㄋㄋ
忻	忄丘丿丿一丨	忄丘丿丿一丨
瞭	目大丶丶丨ㄋ	目大丶丶丨ㄋ
咻	口亻一丨丿丶	口亻一丨丿丶
鹑	子丿ㄋ丶ㄋ	子丿ㄋ丶ㄋ
唑	口从一丨一一	口从一丨一一
皎	白六丿丶丶丶	白六丿丶丶丶
懋	木矛一丨丿丶	木矛一丨丿丶
诒	讠厶丨ㄋ一一	讠厶丨ㄋ一一
麾	麻毛丿一一ㄋ	麻毛丿一一ㄋ
辏	车丿一丿丶	车丿一丿丶
冽	冫歹丨丨丨丨	冫歹丨丨丨丨
氐	氏笔丶丶丶丶	氏笔丶丶丶丶
箕	其丿丶丶丶	其丿丶丶丶
俚	亻田丨ㄋ一一	亻田丨ㄋ一一
宸	宀辰一丿一一	宀辰一丿一一
汴	氵笔一丨丶丶	氵笔一丨丶丶
捱	扌广一丨一一	扌广一丨一一
芍	芍笔丶丶丶丶	芍笔丶丶丶丶
摺	扌羽丿丨ㄋ一	扌羽丿丨ㄋ一
摈	扌宀丿丨一丨	扌宀丿丨一丨
簦	一丨ㄋ一	祭一丨ㄋ一
咝	口幺ㄋㄋ一一	口幺ㄋㄋ一一
箔	氵丿丨ㄋ一	氵丿丨ㄋ一
孀	女一丨丿丶	女一丨丿丶
怏	忄冂一丿丶丶	忄冂一丿丶丶
谝	讠户丨ㄋ一丨	讠户丨ㄋ一丨
漕	氵笔丨ㄋ一丨	氵笔丨ㄋ一丨
砧	石占丨一丨ㄋ	石占丨一丨ㄋ
罂	贝贝丿一一丨	贝贝丿一一丨
耄	者七丿一一ㄋ	者七丿一一ㄋ
馕	食丨ㄋ一丨	食丨ㄋ一丨
烷	火宀一一丿ㄋ	火宀一一丿ㄋ
栾	亦木一丨丿丶	亦木一丨丿丶
沣	氵丰一一一丨	氵丰一一一丨
榘	大一ㄋ一丨	大一ㄋ一丨
鹫	京尢丶丿ㄋ丶	京尢丶丿ㄋ丶
缜	纟直丿丶丶丶	纟直丿丶丶丶
沱	氵宀丿ㄋㄋㄋ	氵宀丿ㄋㄋㄋ
俑	亻甬ㄋ丶丨ㄋ	亻甬ㄋ丶丨ㄋ
榷	木冖丿丨丶一	木冖丿丨丶一
蛳	虫刂一丨ㄋ丨	虫刂一丨ㄋ丨
泗	氵口丿ㄋㄋㄋ	氵口丿ㄋㄋㄋ
衢	彳目丨ㄋ一一	彳目丨ㄋ一一
剽	西示丨丨丨丨	西示丨丨丨丨
臊	月口丨ㄋ一丨	月口丨ㄋ一丨
瘴	疒音一丨丨丨	疒音一丨丨丨
晁	日儿丶一丿丶	日儿丶一丿丶
纾	纟矛ㄋ丶ㄋ丨	纟矛ㄋ丶ㄋ丨
酚	西分丿丶ㄋ丿	西分丿丶ㄋ丿
炀	火㇉丿丿丿丿	火Z丿丿丿丿
孛	子ㄋ丨一一	子ㄋ丨一一
叁	厶三一一一一	厶三一一一一
憩	舌自丶ㄋ丶丶	舌自丶ㄋ丶丶
掬	扌勹丶丿一丨	扌勹丶丿一丨
椤	木四丿ㄋ丶丶	木四丿ㄋ丶丶
啮	口止丨一丨一	口止丨一丨一
畿	幺幺一ㄋ丿丶	幺幺一ㄋ丿丶
镣	金大丶丶丨ㄋ	金大丶丶丨ㄋ
骁	马尧一ㄋ丿一	马尧一ㄋ丿一
掸	扌单丶丿丨ㄋ	扌单丶丿丨ㄋ
侗	亻冂一丨ㄋ一	亻冂一丨ㄋ一
椽	木彑丿ㄋ丿丿	木彑丿ㄋ丿丿
泓	氵弓ㄋ丶丶丶	氵弓ㄋ丶丶丶
酯	西七丨ㄋ一一	西七丨ㄋ一一
滦	氵亦一丨丿丶	氵亦一丨丿丶
蚱	虫乍丿一丨一	虫乍丿一丨一
荩	艹尺丶丶丶丶	艹尺丶丶丶丶
癜	疒尸一丨丨一	疒尸一丨丨一
歆	音欠丿ㄋ丿丶	音欠丿ㄋ丿丶
癸	天一一丿丶	祭天一一丿丶
蹶	广丶丿一ㄋ	广丶丿一ㄋ
扪	扌门丶丨ㄋㄋ	扌门丶丨ㄋㄋ
蚜	虫牙一ㄋ丨丿	虫牙一ㄋ丨丿
蝮	虫丨ㄋ一一	虫丨ㄋ一一
庑	广笔一丿ㄋㄋ	广笔一丿ㄋㄋ
弈	亦开一丿丨丨	亦开一丿丨丨
庋	广十ㄋ丶丶丶	广十ㄋ丶丶丶
喟	口田丨ㄋ一一	口田丨ㄋ一一
滂	氵立丶一ㄋ丿	氵立丶一ㄋ丿
啕	口勹丿一一丨	口勹丿一一丨
蛎	虫广一ㄋ丿丿	虫广一ㄋ丿丿
翊	立羽ㄋ丶一ㄋ	立羽ㄋ丶一ㄋ
龊	止口丨一丿丶	止口丨一丿丶
槁	木丨ㄋ一一	木丨ㄋ一一
獭	犬束丿ㄋ丨ㄋ	犬束丿ㄋ丨ㄋ
莘	艹辛丶一丶丿	艹辛丶一丶丿
邺	业耳ㄋ丨丨丨	业耳ㄋ丨丨丨
燮	讠火丶丿丿丶	讠火丶丿丿丶
铛	金ㄋ一一一	金ㄋ一一一
剁	几木丨丨丨丨	几木丨丨丨丨
觐	堇见丨ㄋ丿ㄋ	堇见丨ㄋ丿ㄋ
谗	讠象丿ㄋ丶丶	讠象丿ㄋ丶丶
臃	月亠ㄋㄋ丿丿	月亠ㄋㄋ丿丿
镍	金自一丨丿丶	金自一丨丿丶
晔	日化一丨丨丨	日化一丨丨丨
墒	土立丨ㄋ一丨	土立丨ㄋ一丨
燔	火釆丨ㄋ一丨	火釆丨ㄋ一丨
嘭	口壴丿丿丿丿	口壴丿丿丿丿
涿	氵豕丶丶丶丶	氵豕丶丶丶丶
醯	西亡丿丨ㄋ丨	西亡丿丨ㄋ丨
箩	四丿ㄋ丶丶	四丿ㄋ丶丶
睨	目鼠丿ㄋㄋㄋ	目鼠丿ㄋㄋㄋ
鄱	釆田ㄋ丨丨丨	釆田ㄋ丨丨丨
鹭	各丿ㄋ丶ㄋ	各丿ㄋ丶ㄋ
坳	土幺ㄋ丿丿丿	土幺ㄋ丿丿丿
砷	石日丨丨丨丨	石日丨丨丨丨
诤	讠争丿ㄋㄋ一	讠争丿ㄋㄋ一
唏	口乂丨ㄋ丨丨	口乂丨ㄋ丨丨
蚩	山笔丨ㄋ一丨	山笔丨ㄋ一丨
琥	王虍丿ㄋㄋㄋ	王虍丿ㄋㄋㄋ
猬	犬田丨ㄋ一一	犬田丨ㄋ一一
殁	歹殳丿ㄋㄋ丶	歹殳丿ㄋㄋ丶
伲	亻尸丿ㄋㄋㄋ	亻尸丿ㄋㄋㄋ
泾	氵轻ㄋ丶一丨	氵轻ㄋ丶一丨
缥	纟西一一丨丿	纟西一一丨丿
殓	歹亼丶丶丿一	歹亼丶丶丿一
鳅	鱼禾丶丿丿丶	鱼禾丶丿丿丶
芷	艹止丨一丨一	艹止丨一丨一
舫	舟方丶一ㄋ丿	舟方丶一ㄋ丿
逅	广鬲丶ㄋ丶丶	广鬲丶ㄋ丶丶
嶙	山米丿ㄋ丶一	山米丿ㄋ丶一
诋	讠氏丶丶丶丶	讠氏丶丶丶丶
刍	刍丿ㄋㄋ一一	刍丿ㄋㄋ一一
氰	气青一一丨一	气青一一丨一
唰	口尸丨ㄋ丨丨	口尸丨ㄋ丨丨
呓	口艹ㄋㄋㄋㄋ	口艹ㄋㄋㄋㄋ
茁	艹山ㄋ丨丨丨	艹山ㄋ丨丨丨
骧	马亠丨ㄋ一丨	马亠丨ㄋ一丨
馑	食堇一丨丨一	食堇一丨丨一
妫	女笔ㄋ丿丶丶	女笔ㄋ丿丶丶
袂	衤匚丿丶丶丶	衤匚丿丶丶丶
峋	山勹丨ㄋ一一	山勹丨ㄋ一一
苷	艹甘一丨丨一	艹甘一丨丨一
擢	扌羽丿丨丶一	扌羽丿丨丶一
懑	氵艹一丨ㄋ丿	氵艹一丨ㄋ丿
蓑	艹一丿ㄋ丿	艹一丿ㄋ丿
踹	山一丿丨ㄋ	山一丿丨ㄋ
祉	衤止丨一丨一	衤止丨一丨一
涞	氵夹丨丿丶丶	氵夹丨丿丶丶
沏	氵七ㄋ丿丿丿	氵七ㄋ丿丿丿
掇	扌双ㄋ丶ㄋ丶	扌双ㄋ丶ㄋ丶
噫	口音丶ㄋ丶丶	口音丶ㄋ丶丶
诳	讠犬一一丨一	讠犬一一丨一
饽	食ㄋ丨一一	食ㄋ丨一一
绺	纟文丨丶丶丶	纟文丨丶丶丶
饪	食王丿一丨一	食王丿一丨一
谘	讠次丨ㄋ一一	讠次丨ㄋ一一
迳	轻辶丶ㄋ丶丶	轻辶丶ㄋ丶丶
飧	歹食丿丶丶ㄋ	歹食丿丶丶ㄋ
铡	金贝丨丨丨丨	金贝丨丨丨丨
枞	木从丿丶丿丶	木从丿丶丿丶
熨	尸示一丨丶丶	尸示一丨丶丶
鋈	氵天丿丶一一	氵天丿丶一一
荭	艹纟一丨一一	艹纟一丨一一
赊	贝人一一丨丿	贝人一一丨丿
戛	石目一ㄋ丿丶	石目一ㄋ丿丶
俦	亻丰一丨丶丶	亻丰一丨丶丶
幺	幺ㄋㄋ丶丶丶	幺ㄋㄋ丶丶丶
湎	氵面一丿丨ㄋ	氵面一丿丨ㄋ
龌	止尸一ㄋ丶一	止尸一ㄋ丶一
芪	艹氏丿ㄋ一ㄋ	艹氏丿ㄋ一ㄋ
觯	角单丶丿丨ㄋ	角单丶丿丨ㄋ
凇	冫木丿丶ㄋ丶	冫木丿丶ㄋ丶
嬴	赢女ㄋ丿一一	赢女ㄋ丿一一
挞	扌大丶ㄋ丶丶	扌大丶ㄋ丶丶
嘁	口戊丨一一一	口戊丨一一一
苻	荷寸一丨丶丶	荷寸一丨丶丶
鞯	革艹一丿丨ㄋ	革艹一丿丨ㄋ
肽	月大丶丶丶丶	月大丶丶丶丶
恸	忄云ㄋ丿丿丿	忄云ㄋ丿丿丿
钰	金王丶丶丶丶	金王丶丶丶丶
迨	厶口丶ㄋ丶丶	厶口丶ㄋ丶丶
儆	亻艹丿ㄋ丨ㄋ	亻艹丿ㄋ丨ㄋ
讫	讠ㄋㄋㄋㄋ	讠ㄋㄋㄋㄋ
觎	亼月丨丨丨ㄋ	亼月丨丨丨ㄋ
僮	亻立丨ㄋ一一	亻立丨ㄋ一一
龇	止此丨一丨一	止此丨一丨一
滓	氵宀丶一丶丿	氵宀丶一丶丿
媾	女共丨ㄋ一丨	女共丨ㄋ一丨
涮	氵尸丨ㄋ丨丨	氵尸丨ㄋ丨丨
胯	月大一一ㄋㄋ	月大一一ㄋㄋ
绾	纟宀丨ㄋ一ㄋ	纟宀丨ㄋ一ㄋ
赳	走丩ㄋ丨丨丨	走丩ㄋ丨丨丨
斛	角冫一丨丨丨	角冫一丨丨丨
杈	木双丶丶丶丶	木双丶丶丶丶
觥	角光丨丶丿一	角光丨丶丿一
疸	疒旦丨ㄋ一一	疒旦丨ㄋ一一
卞	笔下一丨丶丶	笔下一丨丶丶
愠	忄日丨ㄋ丨丨	忄日丨ㄋ丨丨
烨	火化一丨丨丨	火化一丨丨丨
庠	广羊丶丿一一	广羊丶丿一一
拮	扌吉一丨一丨	扌吉一丨一丨
龢	合吅丨ㄋ一丨	合吅丨ㄋ一丨
窈	穴幺ㄋ丿丿丿	穴幺ㄋ丿丿丿
菠	落皮ㄋ丿丨ㄋ	落皮ㄋ丿丨ㄋ
罄	土尸丿ㄋㄋ丶	土尸丿ㄋㄋ丶
腴	月鼠丿丶丶丶	月鼠丿丶丶丶
弁	厶开一丿丨丨	厶开一丿丨丨
囤	口屯一ㄋ丨ㄋ	口屯一ㄋ丨ㄋ
咣	口光丨丶丿一	口光丨丶丿一
奘	片土一丿丶丶	片土一丿丶丶
缫	纟川丨ㄋ一一	纟川丨ㄋ一一
缈	纟目丨丿丶丿	纟目丨丿丶丿
潢	氵共丨ㄋ一丨	氵共丨ㄋ一丨
喵	口艹丨ㄋ一丨	口艹丨ㄋ一丨
柚	木甲丨ㄋ一丨	木甲丨ㄋ一丨
遛	留田丶ㄋ丶丶	留田丶ㄋ丶丶
藜	艹禾丿ㄋㄋㄋ	艹禾丿ㄋㄋㄋ
荻	艹犬丶丿丿丶	艹犬丶丿丿丶
琨	王日一ㄋ丿ㄋ	王日一ㄋ丿ㄋ
郏	夹人ㄋ丨丨丨	夹人ㄋ丨丨丨
镳	金鹿丶丶丶丶	金鹿丶丶丶丶
雉	矢隹丿丨丶一	矢隹丿丨丶一
橐	石一丨丿丶	石一丨丿丶
艮	艮ㄋ一一ㄋ丿	艮ㄋ一一ㄋ丿
骈	马䒑一丿丨丨	马首一丿丨丨
蛉	虫令丿丶丶ㄋ	虫令丿丶丶ㄋ
濡	氵一丿丨ㄋ	氵一丿丨ㄋ
搽	扌艹丿丶一丨	扌艹丿丶一丨
柩	木匚丿ㄋ丶丶	木匚丿ㄋ丶丶
寮	宀大丶丶丨ㄋ	宀大丶丶丨ㄋ
啷	口笔ㄋ一一ㄋ	口笔ㄋ一一ㄋ
佗	亻宀丿ㄋㄋㄋ	亻宀丿ㄋㄋㄋ
诜	讠先丿一丨一	讠先丿一丨一
偻	亻米ㄋ丿一一	亻米ㄋ丿一一
夯	大力ㄋ丿丿丿	大力ㄋ丿丿丿
闱	门韦一一ㄋ丨	门韦一一ㄋ丨
筠	土丿ㄋ丶一	土丿ㄋ丶一
虻	虫亡丶一ㄋㄋ	虫亡丶一ㄋㄋ
夥	日木丿ㄋ丶丿	日木丿ㄋ丶丿
枸	木勹丨ㄋ一一	木勹丨ㄋ一一
膑	月宀丿丨一丨	月宀丿丨一丨
谖	讠爪一一丿ㄋ	讠爪一一丿ㄋ
臾	鼠人丿丶丶丶	鼠人丿丶丶丶
笞	厶丨ㄋ一一	厶丨ㄋ一一
埽	土尹丶ㄋ丨ㄋ	土尹丶ㄋ丨ㄋ
婀	女耳一丨ㄋ一	女耳一丨ㄋ一
珞	王各丿ㄋ丶丨	王各丿ㄋ丶丨
粑	米巴ㄋ丨一ㄋ	米巴ㄋ丨一ㄋ
殒	歹口丨ㄋ丿丶	歹口丨ㄋ丿丶
觊	山巴丨ㄋ丿ㄋ	山巴丨ㄋ丿ㄋ
怵	忄木丶丶丶丶	忄木丶丶丶丶
崂	山萝ㄋ丿丿丿	山萝ㄋ丿丿丿
绻	纟ㄋㄋㄋㄋ	纟ㄋㄋㄋㄋ
昱	日立丶一丶丿	日立丶一丶丿
颧	艹吅丿丨丶一	艹吅丿丨丶一
榛	木一丨丿丶	木一丨丿丶
嗑	口去丨ㄋ丨丨	口去丨ㄋ丨丨
蜴	虫日丿ㄋ丿丿	虫日丿ㄋ丿丿
鳝	鱼羊丶丿一丨	鱼羊丶丿一丨
噙	口人丶一丿丶	口人丶一丿丶
淼	水水丨ㄋ丿丶	水水丨ㄋ丿丶
矾	石几丶丶丶丶	石几丶丶丶丶
囿	口石丨ㄋ一一	口石丨ㄋ一一
硼	石月丿ㄋ一一	石月丿ㄋ一一
邂	角刀丿一一丨	角刀丿一一丨
蠹	石丨ㄋ一丨	石丨ㄋ一丨
钜	金匚ㄋ一一一	金匚ㄋ一一一
泅	氵口丿丶丶丶	氵口丿丶丶丶
垩	亚土一丨一一	亚土一丨一一
嗝	口鬲一丨ㄋ一	口鬲一丨ㄋ一
乩	占乙ㄋㄋㄋㄋ	占乙ㄋㄋㄋㄋ
淦	氵金丿丶一一	氵金丿丶一一
樽	木酋一丨丶丶	木酋一丨丶丶
诮	讠丨ㄋ一一	讠丨ㄋ一一
啐	口亠丿丶丿丶	口亠丿丶丿丶
淅	氵木丿丿一丨	氵木丿丿一丨
揆	扌一一丿丶	扌祭一一丿丶
榉	木丿丶一一	木丿丶一一
辔	纟车ㄋㄋ一丨	纟车ㄋㄋ一丨
骛	矛文ㄋㄋ一一	矛文ㄋㄋ一一
鱿	鱼尢丶丶丶丶	鱼尢丶丶丶丶
暹	日隹丶ㄋ丶丶	日隹丶ㄋ丶丶
馗	九䒑丿丨ㄋ一	九首丿丨ㄋ一
獠	犬大丶丶丨ㄋ	犬大丶丶丨ㄋ
犷	犬广丶一丿丿	犬广丶一丿丿
竦	立束一丨ㄋ一	立束一丨ㄋ一
苫	艹占丨一丨ㄋ	艹占丨一丨ㄋ
詈	四讠丶一一一	四讠丶一一一
篙	丨ㄋ一一	丨ㄋ一一
诨	讠冖一ㄋ一丨	讠冖一ㄋ一丨
滢	氵萝一一丨一	氵萝一一丨一
峒	山冂一丨ㄋ一	山冂一丨ㄋ一
蜚	非虫丨ㄋ一丨	非虫丨ㄋ一丨
馄	食日一ㄋ丿ㄋ	食日一ㄋ丿ㄋ
铰	金六丿丶丶丶	金六丿丶丶丶
靓	青见丨ㄋ丿ㄋ	青见丨ㄋ丿ㄋ
琬	王宀丿ㄋ丶ㄋ	王宀丿ㄋ丶ㄋ
璨	王卜丿ㄋ丶丿	王卜丿ㄋ丶丿
犟	弓口丨ㄋ一丨	弓口丨ㄋ一丨
狻	犬厶丿丶丿ㄋ	犬厶丿丶丿ㄋ
螨	虫艹一丨ㄋ丿	虫艹一丨ㄋ丿
鸬	卜尸丿ㄋ丶ㄋ	卜尸丿ㄋ丶ㄋ
嘹	口大丶丶丨ㄋ	口大丶丶丨ㄋ
芩	艹令丿丶丶ㄋ	艹令丿丶丶ㄋ
锟	金日一ㄋ丿ㄋ	金日一ㄋ丿ㄋ
蜇	折虫丨ㄋ一丨	折虫丨ㄋ一丨
栉	木艹ㄋ丨丨丨	木艹ㄋ丨丨丨
洹	氵笔丨ㄋ一一	氵笔丨ㄋ一一
俪	亻丽一丨ㄋ丶	亻丽一丨ㄋ丶
钍	金土一丨一一	金土一丨一一
瑁	王日丨ㄋ一一	王日丨ㄋ一一
锨	金丘丿ㄋ丿丶	金丘丿ㄋ丿丶
壹	豆一丨ㄋ一	豆一丨ㄋ一
痿	疒禾ㄋ丿一一	疒禾ㄋ丿一一
竑	立石ㄋ丶丶丶	立石ㄋ丶丶丶
犄	牛大一丨ㄋ一	牛大一丨ㄋ一
粕	米白丿丨ㄋ一	米白丿丨ㄋ一
瘙	疒双丶丨ㄋ一	疒双丶丨ㄋ一
衲	衤内丨ㄋ丿丶	衤内丨ㄋ丿丶
饯	食戋一一ㄋ丿	食戋一一ㄋ丿
抟	扌二ㄋ丶丶丶	扌二ㄋ丶丶丶
踮	广丨一丨ㄋ	广丨一丨ㄋ
龅	止勹ㄋ一ㄋㄋ	止勹ㄋ一ㄋㄋ
馥	禾日丿一丨ㄋ	禾日丿一丨ㄋ
愎	忄丨ㄋ一一	忄丨ㄋ一一
梏	木告丿一丨一	木告丿一丨一
邝	广耳ㄋ丨丨丨	广耳ㄋ丨丨丨
讣	讠卜丨丶丶丶	讠卜丨丶丶丶
鲟	鱼尹一丨丶丶	鱼尹一丨丶丶
趺	夫一一丿丶	夫一一丿丶
艿	艹乃ㄋ丿丿丿	艹乃ㄋ丿丿丿
绉	纟刍丿ㄋㄋ一	纟刍丿ㄋㄋ一
剜	宀歹ㄋㄋ丨丨	宀歹ㄋㄋ丨丨
罅	缶虍丿丶丿一	缶虍丿丶丿一
笥	㇉一丨ㄋ一	Z一丨ㄋ一
衩	衤双丶丶丶丶	衤双丶丶丶丶
姣	女六丿丶丶丶	女六丿丶丶丶
斫	石丘丿丿一丨	石丘丿丿一丨
鹗	吅二ㄋ丿ㄋ丶	吅二ㄋ丿ㄋ丶
窕	穴儿丶一丿丶	穴儿丶一丿丶
猕	犬弓丿ㄋ丨丿	犬弓丿ㄋ丨丿
爻	乂乂丿丶丶丶	乂乂丿丶丶丶
晗	日令丨ㄋ一一	日令丨ㄋ一一
铩	金乂一丨丿丶	金乂一丨丿丶
搡	扌双ㄋ丶ㄋ丶	扌双ㄋ丶ㄋ丶
崴	山戊一ㄋ丿一	山戊一ㄋ丿一
仨	亻三一一一一	亻三一一一一
酢	西乍丿一丨一	西乍丿一丨一
璀	王山丿丨丶一	王山丿丨丶一
佞	亻二ㄋ丿一一	亻二ㄋ丿一一
檄	木白丶一ㄋ丿	木白丶一ㄋ丿
岷	山民ㄋ一ㄋ一	山民ㄋ一ㄋ一
邕	川口ㄋ丨一ㄋ	川口ㄋ丨一ㄋ
舛	歹㐄一ㄋ丨丨	歹年一ㄋ丨丨
闿	门山ㄋ一ㄋㄋ	门山ㄋ一ㄋㄋ
霁	文丿丨丨丨	文丿丨丨丨
铂	金白丿丨ㄋ一	金白丿丨ㄋ一
犒	牛丨ㄋ一一	牛丨ㄋ一一
麒	鹿其一丨丨一	鹿其一丨丨一
阈	门戋丨ㄋ一一	门戋丨ㄋ一一
馏	食留丨ㄋ一丨	食留丨ㄋ一丨
麋	鹿米丶丿一丨	鹿米丶丿一丨
妍	女开一一丿丨	女开一一丿丨
涔	氵山丿丶丶ㄋ	氵山丿丶丶ㄋ
摁	扌因丶ㄋ丶丶	扌因丶ㄋ丶丶
宥	宀石丨ㄋ一一	宀石丨ㄋ一一
铤	金王ㄋ丶丶丶	金王ㄋ丶丶丶
锷	金吅一一ㄋㄋ	金吅一一ㄋㄋ
苁	艹从丿丶丿丶	艹从丿丶丿丶
嗲	口父丿ㄋ丶丿	口父丿ㄋ丶丿
恽	忄冖一ㄋ一丨	忄冖一ㄋ一丨
麂	鹿几丿ㄋㄋㄋ	鹿几丿ㄋㄋㄋ
胛	月甲丨ㄋ一一	月甲丨ㄋ一一
赝	广亻丿丨丶一	广亻丿丨丶一
哂	口西一丨ㄋ丿	口西一丨ㄋ丿
噘	口广丶丿一ㄋ	口广丶丿一ㄋ
呶	口女ㄋ丶丶丶	口女ㄋ丶丶丶
飨	幺笔丿丶丶ㄋ	幺笔丿丶丶ㄋ
撷	扌吉一丿丨ㄋ	扌吉一丿丨ㄋ
栎	木留丨丿丶丶	木留丨丿丶丶
懔	忄亠丨ㄋ丨ㄋ	忄亠丨ㄋ丨ㄋ
桎	木至一ㄋ丶一	木至一ㄋ丶一
霰	共丨ㄋ一一	共丨ㄋ一一
娣	女弓丶丿ㄋ一	女弓丶丿ㄋ一
揄	扌亼丨ㄋ一一	扌亼丨ㄋ一一
噔	口一丨ㄋ一	口祭一丨ㄋ一
咤	口宀丿一ㄋㄋ	口宀丿一ㄋㄋ
忝	天小丨丶丶丶	天小丨丶丶丶
薏	艹音丶ㄋ丶丶	艹音丶ㄋ丶丶
贲	十艹丨ㄋ丿丶	十艹丨ㄋ丿丶
迤	也丶ㄋ丶丶	也丶ㄋ丶丶
泸	氵卜ㄋ一丿丿	氵卜ㄋ一丿丿
嗵	口甬丶ㄋ丶丶	口甬丶ㄋ丶丶
胪	月卜ㄋ一丿丿	月卜ㄋ一丿丿
鍪	矛文丿丶一一	矛文丿丶一一
咿	口亻ㄋ一一丿	口亻ㄋ一一丿
鹌	大日ㄋ丿ㄋ丶	大日ㄋ丿ㄋ丶
蔫	艹正ㄋ一丶丶	艹正ㄋ一丶丶
僖	亻壴丨ㄋ一一	亻壴丨ㄋ一一
刈	乂刂丨丨丨丨	乂刂丨丨丨丨
嗪	口一丨丿丶	口一丨丿丶
铨	金人一一丨一	金人一一丨一
嵘	山萝一丨丿丶	山萝一丨丿丶
岫	山甲丨ㄋ一丨	山甲丨ㄋ一丨
茏	艹龙一丿ㄋ丿	艹龙一丿ㄋ丿
茯	荷犬一丿丶丶	荷犬一丿丶丶
怼	双寸丶ㄋ丶丶	双寸丶ㄋ丶丶
轱	车十丨ㄋ一一	车十丨ㄋ一一
昕	日丘丿丿一丨	日丘丿丿一丨
郢	口王ㄋ丨丨丨	口王ㄋ丨丨丨
咩	口羊丶丿一一	口羊丶丿一一
馊	食鼠丨ㄋ丶丶	食鼠丨ㄋ丶丶
澧	氵甲一丨ㄋ一	氵甲一丨ㄋ一
髡	长笔丿ㄋㄋㄋ	长笔丿ㄋㄋㄋ
濯	氵羽丿丨丶一	氵羽丿丨丶一
盥	鼠水丨ㄋ丨丨	鼠水丨ㄋ丨丨
苣	艹匚ㄋ一一一	艹匚ㄋ一一一
囡	口女ㄋ丿一一	口女ㄋ丿一一
砺	石广一ㄋ丿丿	石广一ㄋ丿丿
佘	人示一一丨丿	人示一一丨丿
翦	前羽ㄋ丶一ㄋ	前羽ㄋ丶一ㄋ
弑	乂木一ㄋ丶一	乂木一ㄋ丶一
楂	木木丨ㄋ一一	木木丨ㄋ一一
谶	讠从一ㄋ丿丶	讠从一ㄋ丿丶
霏	非丨一一一	非丨一一一
怩	忄尸丿ㄋㄋㄋ	忄尸丿ㄋㄋㄋ
楹	木乃ㄋ丶丨ㄋ	木乃ㄋ丶丨ㄋ
蠼	虫目丨ㄋ一一	虫目丨ㄋ一一
讴	讠区一丿丶ㄋ	讠区一丿丶ㄋ
锲	金丰ㄋ丿丿丿	金丰ㄋ丿丿丿
慵	忄广ㄋ一一丨	忄广ㄋ一一丨
砭	石笔丶ㄋ丶丶	石笔丶ㄋ丶丶
胝	月氏丶丶丶丶	月氏丶丶丶丶
杵	木一丨丨丨	木一丨丨丨
潍	氵纟丿丨丶一	氵纟丿丨丶一
樾	木走一ㄋㄋ丿	木走一ㄋㄋ丿
帼	巾口一一丨一	巾口一一丨一
碣	石日丿ㄋ丿丶	石日丿ㄋ丿丶
裟	氵少丶一丿ㄋ	氵少丶一丿ㄋ
诌	讠刍丿ㄋㄋ一	讠刍丿ㄋㄋ一
胴	月冂一丨ㄋ一	月冂一丨ㄋ一
啶	口定丶丶ㄋ一	口定丶丶ㄋ一
徕	彳夹丨丿丶丶	彳夹丨丿丶丶
钴	金古一丨丨ㄋ	金古一丨丨ㄋ
楫	木口一丨丨一	木口一丨丨一
赭	赤者一丨一丿	赤者一丨一丿
铣	金先丿一丨一	金先丿一丨一
铱	金衣丶一丿ㄋ	金衣丶一丿ㄋ
酊	西于一丨丨丨	西于一丨丨丨
魑	鬼㐫丨ㄋㄋ丶	鬼离丨ㄋㄋ丶
醛	西艹丿丶一一	西艹丿丶一一
碛	石丰丨ㄋ丿丶	石丰丨ㄋ丿丶
剐	口内丨丨丨丨	口内丨丨丨丨
陂	耳皮ㄋ丿丨ㄋ	耳皮ㄋ丿丨ㄋ
畦	田圭一丨一一	田圭一丨一一
阄	门鱼丨ㄋ一一	门鱼丨ㄋ一一
闶	门亠丿ㄋㄋㄋ	门亠丿ㄋㄋㄋ
祚	衤乍丿一丨一	衤乍丿一丨一
鹘	骨鸟丿ㄋ丶ㄋ	骨鸟丿ㄋ丶ㄋ
骅	马化一丨丨丨	马化一丨丨丨
泱	氵冂一丿丶丶	氵冂一丿丶丶
趄	走目丨ㄋ一一	走目丨ㄋ一一
陲	耳垂丿一丨一	耳垂丿一丨一
倜	亻冂一丨一丨	亻冂一丨一丨
燧	火冫一丿ㄋ丿	火冫一丿ㄋ丿
呤	口令丿丶丶ㄋ	口令丿丶丶ㄋ
铉	金亠ㄋㄋ丶丶	金亠ㄋㄋ丶丶
郧	口贝ㄋ丨丨丨	口贝ㄋ丨丨丨
粲	卜歹ㄋ丶丶丿	卜歹ㄋ丶丶丿
骶	骨氏丶丶丶丶	骨氏丶丶丶丶
髭	长此丨一丨一	长此丨一丨一
忸	忄丑ㄋ丨一一	忄丑ㄋ丨一一
骞	寒马ㄋㄋ一一	寒马ㄋㄋ一一
渌	氵尹丨ㄋ丿丶	氵尹丨ㄋ丿丶
戡	其乙一ㄋ丿丶	其乙一ㄋ丿丶
峁	山留丿ㄋ丿ㄋ	山留丿ㄋ丿ㄋ
谲	讠矛丨ㄋ丿丶	讠矛丨ㄋ丿丶
锃	金口一一丨一	金口一一丨一
苋	艹见丨ㄋ丿ㄋ	艹见丨ㄋ丿ㄋ
钨	金勹ㄋ一一一	金勹ㄋ一一一
蜊	虫禾丨丨丨丨	虫禾丨丨丨丨
骊	马丽一丨ㄋ丶	马丽一丨ㄋ丶
幄	巾尸一ㄋ丶一	巾尸一ㄋ丶一
戕	片戋一ㄋ丿丶	片戋一ㄋ丿丶
闼	门大丶ㄋ丶丶	门大丶ㄋ丶丶
虢	爪寸丨一ㄋ丿	爪寸丨一ㄋ丿
妲	女旦丨ㄋ一一	女旦丨ㄋ一一
袈	加衣丶一丿ㄋ	加衣丶一丿ㄋ
烩	火人一一ㄋ丶	火人一一ㄋ丶
傥	亻丿ㄋㄋㄋ	亻丿ㄋㄋㄋ
桠	木亚一丨丨丶	木亚一丨丨丶
绌	纟山ㄋ丨丨丨	纟山ㄋ丨丨丨
揿	扌金丿ㄋ丿丶	扌金丿ㄋ丿丶
薮	艹米ㄋ丿一丿	艹米ㄋ丿一丿
肓	亡月丨ㄋ一一	亡月丨ㄋ一一
杲	日木一丨丿丶	日木一丨丿丶
氤	气因丨ㄋ一丿	气因丨ㄋ一丿
莅	荷立丶一丶丿	荷立丶一丶丿
厝	广共丨ㄋ一一	广共丨ㄋ一一
缙	纟亚丨ㄋ一一	纟亚丨ㄋ一一
衮	六厶丿ㄋ丿丶	六厶丿ㄋ丿丶
旖	族大一丨ㄋ一	族大一丨ㄋ一
诟	讠广一丨ㄋ一	讠广一丨ㄋ一
硒	石西一丨ㄋ丿	石西一丨ㄋ丿
颦	止小一丿丨ㄋ	止小一丿丨ㄋ
裱	衤丰丿ㄋ丿丶	衤丰丿ㄋ丿丶
唁	口讠丶一一一	口讠丶一一一
嬗	女亠丨ㄋ丨ㄋ	女亠丨ㄋ丨ㄋ
硎	石开一一丿丨	石开一一丿丨
靥	广犬一丿丨ㄋ	广犬一丿丨ㄋ
礴	石落一丨ㄋ一	石落一丨ㄋ一
煨	火田一一一一	火田一一一一
鏖	鹿金丿丶一一	鹿金丿丶一一
纥	纟ㄋㄋㄋㄋ	纟ㄋㄋㄋㄋ
羿	羽开一丿丨丨	羽开一丿丨丨
笏	勿丿ㄋ丿丿	勿丿ㄋ丿丿
蝈	虫口一一丨一	虫口一一丨一
炜	火韦一一ㄋ丨	火韦一一ㄋ丨
煲	亻呆丶丿丿丶	亻呆丶丿丿丶
锉	金从一丨一一	金从一丨一一
湟	氵白一一丨一	氵白一一丨一
甑	曾瓦一ㄋㄋ丶	曾瓦一ㄋㄋ丶
鼐	乃目ㄋ一丿丨	乃目ㄋ一丿丨
笕	见丨ㄋ丿ㄋ	见丨ㄋ丿ㄋ
妪	女区一丿丶ㄋ	女区一丿丶ㄋ
嶂	山音一丨丨丨	山音一丨丨丨
弭	弓耳一丨丨一	弓耳一丨丨一
浔	氵尹一丨丶丶	氵尹一丨丶丶
喑	口音丶一丶丿	口音丶一丶丿
锂	金田丨ㄋ一一	金田丨ㄋ一一
颏	亥页一丿丨ㄋ	亥页一丿丨ㄋ
醴	西甲一丨ㄋ一	西甲一丨ㄋ一
孳	䒑幺ㄋㄋ丶ㄋ	首幺ㄋㄋ丶ㄋ
苡	艹以ㄋ丶丿丶	艹以ㄋ丶丿丶
渚	氵者一丨一丿	氵者一丨一丿
轭	车广ㄋㄋㄋㄋ	车广ㄋㄋㄋㄋ
蚝	虫毛丿一一ㄋ	虫毛丿一一ㄋ
鹬	矛冂丿丶丨ㄋ	矛冂丿丶丨ㄋ
耦	未日丨ㄋ丨一	未日丨ㄋ丨一
覃	西日一丨丨丨	西日一丨丨丨
膘	月西一一丨丿	月西一一丨丿
痨	疒萝ㄋ丿丿丿	疒萝ㄋ丿丿丿
褡	衤艹丿丶一丨	衤艹丿丶一丨
邛	工耳ㄋ丨丨丨	工耳ㄋ丨丨丨
馔	食巴ㄋ一ㄋ一	食巴ㄋ一ㄋ一
篾	四一丿ㄋ丿	四一丿ㄋ丿
兖	六厶丿ㄋㄋㄋ	六厶丿ㄋㄋㄋ
遨	敖辶丶ㄋ丶丶	敖辶丶ㄋ丶丶
艄	舟丨ㄋ一一	舟丨ㄋ一一
爰	爪笔一丿ㄋ丶	爪笔一丿ㄋ丶
痂	疒加ㄋ丿丨ㄋ	疒加ㄋ丿丨ㄋ
阋	门鼠丿ㄋㄋㄋ	门鼠丿ㄋㄋㄋ
耨	未辰一丨丶丶	未辰一丨丶丶
邋	川口丿丶ㄋ丶	川口丿丶ㄋ丶
昶	笔㇉ㄋ丿丶丨	笔Zㄋ丿丶丨
秣	禾未丨丿丶丶	禾未丨丿丶丶
沤	氵区一丿丶ㄋ	氵区一丿丶ㄋ
焓	火令丨ㄋ一一	火令丨ㄋ一一
俎	从目丨ㄋ一一	从目丨ㄋ一一
绦	纟文一丨丿丶	纟文一丨丿丶
窣	穴亠丿丶丿丶	穴亠丿丶丿丶
榫	木隹一丨丨丨	木隹一丨丨丨
蟪	虫笔丨ㄋ一一	虫笔丨ㄋ一一
烃	火轻ㄋ丶一丨	火轻ㄋ丶一丨
稗	禾卑丿丨ㄋ一	禾卑丿丨ㄋ一
锴	金比丿丨ㄋ一	金比丿丨ㄋ一
龉	止五丨ㄋ一一	止五丨ㄋ一一
謇	寒讠丶一一一	寒讠丶一一一
氩	气亚一丨丨丶	气亚一丨丨丶
嬷	女麻丿ㄋ丶丶	女麻丿ㄋ丶丶
鸢	戋鸟丿ㄋ丶ㄋ	戋鸟丿ㄋ丶ㄋ
肱	月石ㄋ丶丶丶	月石ㄋ丶丶丶
痤	疒从一丨一一	疒从一丨一一
笫	弓丶丿ㄋ一	弓丶丿ㄋ一
俣	亻口一一丿丶	亻口一一丿丶
阕	门一一丿丶	门祭一一丿丶
莆	艹甫一丨ㄋ一	艹甫一丨ㄋ一
鼹	鼠日丶丶ㄋㄋ	鼠日丶丶ㄋㄋ
菏	落可一丨ㄋ一	落可一丨ㄋ一
碜	石厶丿丿丿丿	石厶丿丿丿丿
砣	石宀丿ㄋㄋㄋ	石宀丿ㄋㄋㄋ
芨	艹及丿ㄋ丶丶	艹及丿ㄋ丶丶
猷	酋犬一丿丶丶	酋犬一丿丶丶
舸	舟可一丨ㄋ一	舟可一丨ㄋ一
竽	于一一丨丨	于一一丨丨
诓	讠匚一一丨一	讠匚一一丨一
錾	车丘丿丶一一	车丘丿丶一一
婕	女笔ㄋ一一丨	女笔ㄋ一一丨
淬	氵亠丿丶丿丶	氵亠丿丶丿丶
邈	豸白丿ㄋ丶ㄋ	豸白丿ㄋ丶ㄋ
姘	女䒑一丿丨丨	女首一丿丨丨
隗	耳鬼丿丨ㄋ一	耳鬼丿丨ㄋ一
悌	忄弓丶丿ㄋ一	忄弓丶丿ㄋ一
槭	木戊丨一一丨	木戊丨一一丨
稹	禾直丿丶丶丶	禾直丿丶丶丶
蹴	京一丿ㄋ丶	京一丿ㄋ丶
歙	合羽丿ㄋ丿丶	合羽丿ㄋ丿丶
豕	豕一丿ㄋ丿丿	豕一丿ㄋ丿丿
羯	羊日丿ㄋ丿丶	羊日丿ㄋ丿丶
砒	石比一ㄋ丿ㄋ	石比一ㄋ丿ㄋ
痈	疒甬丿ㄋ一一	疒甬丿ㄋ一一
镏	金留丨ㄋ一丨	金留丨ㄋ一丨
鲂	鱼方丶一ㄋ丿	鱼方丶一ㄋ丿
蓖	艹丿丶一一	艹丿丶一一
笤	刀丨ㄋ一一	刀丨ㄋ一一
匦	匚车丿ㄋㄋㄋ	匚车丿ㄋㄋㄋ
峥	山争丿ㄋㄋ一	山争丿ㄋㄋ一
浃	氵夹丿丶丶丶	氵夹丿丶丶丶
烊	火羊丶丿一一	火羊丶丿一一
徭	彳爪丿一一丨	彳爪丿一一丨
翳	匚矢丿ㄋㄋ丶	匚矢丿ㄋㄋ丶
褓	衤亻丨ㄋ一一	衤亻丨ㄋ一一
缢	纟䒑丿丶丨ㄋ	纟首丿丶丨ㄋ
趔	走歹丨丨丨丨	走歹丨丨丨丨
酆	山丰一一一丨	山丰一一一丨
蚨	虫夫一一丿丶	虫夫一一丿丶
窸	穴釆丶ㄋ丶丶	穴釆丶ㄋ丶丶
泷	氵龙一丿ㄋ丿	氵龙一丿ㄋ丿
仃	亻于一丨丨丨	亻于一丨丨丨
勖	日目ㄋ丿丿丿	日目ㄋ丿丿丿
誊	讠丶一一一	讠丶一一一
炔	火匚丿丶丶丶	火匚丿丶丶丶
葺	艹口一丨丨一	艹口一丨丨一
蚴	虫幺ㄋ丿丿丿	虫幺ㄋ丿丿丿
赜	臣丰丨ㄋ丿丶	臣丰丨ㄋ丿丶
蛴	虫文丿丨丨丨	虫文丿丨丨丨
媸	女山一丨ㄋ一	女山一丨ㄋ一
孱	尸子ㄋ丨一ㄋ	尸子ㄋ丨一ㄋ
逡	厶八丿ㄋ丶丶	厶八丿ㄋ丶丶
俳	亻非丨一一一	亻非丨一一一
砦	此石一丿丨ㄋ	此石一丿丨ㄋ
祜	衤古一丨丨ㄋ	衤古一丨丨ㄋ
跸	比一丨丨丨	比一丨丨丨
诖	讠圭一丨一一	讠圭一丨一一
茑	艹鸟丿ㄋ丶ㄋ	艹鸟丿ㄋ丶ㄋ
飚	几乂丶丿丿丶	几乂丶丿丿丶
屐	尸彳一丨ㄋ丶	尸彳一丨ㄋ丶
溴	氵自一丿丶丶	氵自一丿丶丶
伉	亻亠丿ㄋㄋㄋ	亻亠丿ㄋㄋㄋ
蛞	虫舌丿一丨丨	虫舌丿一丨丨
崆	山穴一丨一一	山穴一丨一一
鸨	七十丿ㄋ丶ㄋ	七十丿ㄋ丶ㄋ
庾	广鼠丿丶丶丶	广鼠丿丶丶丶
掮	扌户丨ㄋ一一	扌户丨ㄋ一一
蒯	艹月丿ㄋ一一	艹月丿ㄋ一一
圻	土丘丿丿一丨	土丘丿丿一丨
橛	木广丶丿一ㄋ	木广丶丿一ㄋ
矸	石舌一一丨丨	石舌一一丨丨
缂	纟革一丨丨一	纟革一丨丨一
鸪	古鸟丿ㄋ丶ㄋ	古鸟丿ㄋ丶ㄋ
啭	口车一一ㄋ丶	口车一一ㄋ丶
蛩	工几丶丨ㄋ一	工几丶丨ㄋ一
蠖	虫艹丿丨丶一	虫艹丿丨丶一
镉	金鬲一丨ㄋ一	金鬲一丨ㄋ一
饧	食㇉丿丿丿丿	食Z丿丿丿丿
诹	讠耳ㄋ丶丶丶	讠耳ㄋ丶丶丶
劭	刀口ㄋ丿丿丿	刀口ㄋ丿丿丿
遑	白王丶ㄋ丶丶	白王丶ㄋ丶丶
棂	木尹丶丿丿丶	木尹丶丿丿丶
螫	赤文丨ㄋ一丨	赤文丨ㄋ一丨
哐	口匚一一丨一	口匚一一丨一
杼	木矛ㄋ丶ㄋ丨	木矛ㄋ丶ㄋ丨
颢	日京一丿丨ㄋ	日京一丿丨ㄋ
崧	山木丿丶丶丶	山木丿丶丶丶
龃	止目丨ㄋ一一	止目丨ㄋ一一
饔	亠幺丿丿丨丶	亠幺丿丿丨丶
襁	衤弓丨ㄋ一丨	衤弓丨ㄋ一丨
腱	月聿ㄋ丶丶丶	月聿ㄋ丶丶丶
濠	氵一丿ㄋ丿	氵一丿ㄋ丿
牝	牛七丿ㄋㄋㄋ	牛七丿ㄋㄋㄋ
忾	忄气丿一一ㄋ	忄气丿一一ㄋ
鲆	鱼平一丶丿一	鱼平一丶丿一
蛄	虫古一丨丨ㄋ	虫古一丨丨ㄋ
嗄	口石丨ㄋ一一	口石丨ㄋ一一
灏	氵日丶一丨ㄋ	氵日丶一丨ㄋ
荞	艹天丿丨丨丨	艹天丿丨丨丨
苜	艹目丨ㄋ一一	艹目丨ㄋ一一
嘣	口山丿ㄋ一一	口山丿ㄋ一一
疥	疒人丿丨丨丨	疒人丿丨丨丨
夤	歹宀一丿丶丨	歹宀一丿丶丨
颞	耳双一丿丨ㄋ	耳双一丿丨ㄋ
砝	石去一丨一ㄋ	石去一丨一ㄋ
辇	夫夫一ㄋ一丨	夫夫一ㄋ一丨
遢	日羽丶ㄋ丶丶	日羽丶ㄋ丶丶
忤	忄一丨丨丨	忄一丨丨丨
旎	族尸丿ㄋㄋㄋ	族尸丿ㄋㄋㄋ
魉	鬼丙丿丶丿丶	鬼丙丿丶丿丶
瘛	疒丰ㄋ丿丶ㄋ	疒丰ㄋ丿丶ㄋ
荥	萝水丨ㄋ丿丶	萝水丨ㄋ丿丶
毂	车丿ㄋㄋ丶	车丿ㄋㄋ丶
娌	女田丨ㄋ一一	女田丨ㄋ一一
涫	氵宀丨ㄋ一ㄋ	氵宀丨ㄋ一ㄋ
碇	石定丶丶ㄋ一	石定丶丶ㄋ一
瓤	亠吅一一丨丨	亠吅一一丨丨
氚	气川丿丨丨丨	气川丿丨丨丨
臁	月广丶丿一ㄋ	月广丶丿一ㄋ
玮	王韦一一ㄋ丨	王韦一一ㄋ丨
羟	羊轻ㄋ丶一丨	羊轻ㄋ丶一丨
吡	口比一ㄋ丿ㄋ	口比一ㄋ丿ㄋ
壅	亠幺丿丿丨丶	亠幺丿丿丨丶
缛	纟辰一丨丶丶	纟辰一丨丶丶
毖	比心丿丿丿丿	比心丿丿丿丿
珈	王加ㄋ丿丨ㄋ	王加ㄋ丿丨ㄋ
颀	丘页一丿丨ㄋ	丘页一丿丨ㄋ
虼	虫ㄋㄋㄋㄋ	虫ㄋㄋㄋㄋ
珏	王王丶丶丶丶	王王丶丶丶丶
翕	合羽ㄋ丶一ㄋ	合羽ㄋ丶一ㄋ
佝	亻勹丨ㄋ一一	亻勹丨ㄋ一一
遴	米歹一ㄋ丨丶	米歹一ㄋ丨丶
祇	衤氏丿ㄋ一ㄋ	衤氏丿ㄋ一ㄋ
郛	爪子ㄋ丨丨丨	爪子ㄋ丨丨丨
玖	王久丿ㄋ丶丶	王久丿ㄋ丶丶
粽	米宀一一丨丿	米宀一一丨丿
蹇	寒口丨一丿丶	寒口丨一丿丶
氅	冂丨ㄋ一丿	冂丨ㄋ一丿
逋	甫辶丶ㄋ丶丶	甫辶丶ㄋ丶丶
诂	讠古一丨丨ㄋ	讠古一丨丨ㄋ
聒	耳舌丿一丨丨	耳舌丿一丨丨
髁	骨日一丨丿丶	骨日一丨丿丶
岢	山可一丨ㄋ一	山可一丨ㄋ一
黍	禾人丨丶一丿	禾人丨丶一丿
闳	门石ㄋ丶丶丶	门石ㄋ丶丶丶
鞣	革矛一丨丿丶	革矛一丨丿丶
髋	骨宀一丨丨丨	骨宀一丨丨丨
淝	氵月ㄋ丨一ㄋ	氵月ㄋ丨一ㄋ
潆	氵萝ㄋㄋ丶丨	氵萝ㄋㄋ丶丨
鲎	鱼丿ㄋ丨ㄋ	鱼丿ㄋ丨ㄋ
芾	艹笔丨ㄋ丨丨	艹笔丨ㄋ丨丨
汨	氵日丨ㄋ一一	氵日丨ㄋ一一
胍	月爪丿丿ㄋ丶	月爪丿丿ㄋ丶
戬	亚日一ㄋ丿丶	亚日一ㄋ丿丶
鬈	长ㄋㄋㄋㄋ	长ㄋㄋㄋㄋ
铵	金宀ㄋ丿一一	金宀ㄋ丿一一
鹜	矛文丿ㄋ丶ㄋ	矛文丿ㄋ丶ㄋ
钤	金令丿丶丶ㄋ	金令丿丶丶ㄋ
阏	门方丿丶丶丶	门方丿丶丶丶
衾	令衣丶一丿ㄋ	令衣丶一丿ㄋ
脍	月人一一ㄋ丶	月人一一ㄋ丶
畲	人示丨ㄋ一丨	人示丨ㄋ一丨
枰	木平一丶丿一	木平一丶丿一
樯	木十丶丿一丨	木十丶丿一丨
蹼	业丶丿一一	业丶丿一一
崮	山口一丨丨ㄋ	山口一丨丨ㄋ
洱	氵耳一丨丨一	氵耳一丨丨一
咭	口吉一丨一丨	口吉一丨一丨
囫	口勿丿ㄋ丿丿	口勿丿ㄋ丿丿
劬	勹口ㄋ丿丿丿	勹口ㄋ丿丿丿
刎	勿刂丨丨丨丨	勿刂丨丨丨丨
鳕	鱼ㄋ一一一	鱼ㄋ一一一
琊	王牙ㄋ丨丨丨	王牙ㄋ丨丨丨
碚	石立丨ㄋ一一	石立丨ㄋ一一
芏	艹土一丨一一	艹土一丨一一
恂	忄勹丨ㄋ一一	忄勹丨ㄋ一一
谪	讠立丨ㄋ丿丶	讠立丨ㄋ丿丶
槿	木堇一丨丨一	木堇一丨丨一
嘧	口宀丶ㄋ丶丿	口宀丶ㄋ丶丿
绀	纟甘一丨丨一	纟甘一丨丨一
鲧	鱼笔ㄋㄋ丶丨	鱼笔ㄋㄋ丶丨
芎	艹弓ㄋ一ㄋㄋ	艹弓ㄋ一ㄋㄋ
鲢	鱼车丶ㄋ丶丶	鱼车丶ㄋ丶丶
潸	氵林丨ㄋ一一	氵林丨ㄋ一一
鲶	鱼令丶ㄋ丶丶	鱼令丶ㄋ丶丶
噱	口虍一丿ㄋ丿	口虍一丿ㄋ丿
郦	丽耳ㄋ丨丨丨	丽耳ㄋ丨丨丨
浠	氵乂丨ㄋ丨丨	氵乂丨ㄋ丨丨
跏	加ㄋ丿丨ㄋ	加ㄋ丿丨ㄋ
琰	王火丶丿丿丶	王火丶丿丿丶
抻	扌日丨丨丨丨	扌日丨丨丨丨
臬	自木一丨丿丶	自木一丨丿丶
矍	目目丿丨丶一	目目丿丨丶一
鹚	䒑幺ㄋㄋ丶丿	首幺ㄋㄋ丶丿
苌	艹长丿一ㄋ丶	艹长丿一ㄋ丶
龆	止刀丨ㄋ一一	止刀丨ㄋ一一
觞	角ㄋ丿丿丿	角ㄋ丿丿丿
雒	各隹丿丨丶一	各隹丿丨丶一
呔	口大丶丶丶丶	口大丶丶丶丶
芄	艹九丶丶丶丶	艹九丶丶丶丶
阒	门目一丿丶丶	门目一丿丶丶
槎	木羊一丨一一	木羊一丨一一
舂	鼠丿丨一ㄋ	鼠丿丨一ㄋ
鸩	冖儿丿ㄋ丶ㄋ	冖儿丿ㄋ丶ㄋ
钒	金几丶丶丶丶	金几丶丶丶丶
饫	食天丿一丿丶	食天丿一丿丶
阡	耳舌丿一丨丨	耳舌丿一丨丨
稔	禾令丶ㄋ丶丶	禾令丶ㄋ丶丶
莒	艹口丨ㄋ一一	艹口丨ㄋ一一
萸	艹鼠丿丶丶丶	艹鼠丿丶丶丶
穰	禾亠丨ㄋ一丨	禾亠丨ㄋ一丨
蚧	虫人丿丨丨丨	虫人丿丨丨丨
餍	广犬丿丶丶ㄋ	广犬丿丶丶ㄋ
妗	女令丿丶丶ㄋ	女令丿丶丶ㄋ
谠	讠丿ㄋㄋㄋ	讠丿ㄋㄋㄋ
葩	艹白ㄋ丨一ㄋ	艹白ㄋ丨一ㄋ
谯	讠隹丶丶丶丶	讠隹丶丶丶丶
菸	艹方丿丶丶丶	艹方丿丶丶丶
芗	艹幺丿丿丿丿	艹幺丿丿丿丿
踔	卜丨ㄋ一一	卜丨ㄋ一一
佻	亻儿丶一丿丶	亻儿丶一丿丶
倨	亻尸一丨丨ㄋ	亻尸一丨丨ㄋ
钏	金川丿丨丨丨	金川丿丨丨丨
黩	黑十ㄋ丶丶一	黑十ㄋ丶丶一
饩	食气丿一一ㄋ	食气丿一一ㄋ
嘌	口西一一丨丿	口西一一丨丿
厣	广犬丨ㄋ一一	广犬丨ㄋ一一
蠓	虫萝一一丿ㄋ	虫萝一一丿ㄋ
恁	亻王丶ㄋ丶丶	亻王丶ㄋ丶丶
钿	金田丨ㄋ一丨	金田丨ㄋ一丨
殚	歹单丶丿丨ㄋ	歹单丶丿丨ㄋ
藿	艹丿丨丶一	艹丿丨丶一
鎏	氵亡丿丨ㄋㄋ	氵亡丿丨ㄋㄋ
缬	纟吉一丿丨ㄋ	纟吉一丿丨ㄋ
瓯	区瓦一ㄋㄋ丶	区瓦一ㄋㄋ丶
酩	西歹丨ㄋ一一	西歹丨ㄋ一一
旃	族冂丶一一一	族冂丶一一一
呋	口夫一一丿丶	口夫一一丿丶
婺	矛文ㄋ丿一一	矛文ㄋ丿一一
鄣	音十ㄋ丨丨丨	音十ㄋ丨丨丨
囟	乂一一一一	乂一一一一
锶	金田丶ㄋ丶丶	金田丶ㄋ丶丶
绱	纟丨ㄋ丨ㄋ	纟丨ㄋ丨ㄋ
恹	忄广一丿丶丶	忄广一丿丶丶
缦	纟日丨ㄋ丨丨	纟日丨ㄋ丨丨
逶	禾女丶ㄋ丶丶	禾女丶ㄋ丶丶
鸹	舌鸟丿ㄋ丶ㄋ	舌鸟丿ㄋ丶ㄋ
邬	勹㇉一ㄋ丨丨	勹Z一ㄋ丨丨
殇	歹ㄋ丿丿丿	歹ㄋ丿丿丿
媪	女日丨ㄋ丨丨	女日丨ㄋ丨丨
阗	门直丿丶丶丶	门直丿丶丶丶
鲛	鱼六丿丶丶丶	鱼六丿丶丶丶
篑	丨ㄋ丿丶	丨ㄋ丿丶
讦	讠舌一一丨丨	讠舌一一丨丨
螟	虫冖丨ㄋ一一	虫冖丨ㄋ一一
醪	西羽丿丶丿丿	西羽丿丶丿丿
菟	艹象丿ㄋ丶丶	艹象丿ㄋ丶丶
濉	氵目丿丨丶一	氵目丿丨丶一
峤	山天丿丨丨丨	山天丿丨丨丨
芡	艹欠丿ㄋ丿丶	艹欠丿ㄋ丿丶
鄯	羊䒑丨ㄋ一ㄋ	羊首丨ㄋ一ㄋ
肼	月二一一丿丨	月二一一丿丨
嫠	未文一丿ㄋ丿	未文一丿ㄋ丿
愆	彳氵一一丨丶	彳氵一一丨丶
掼	扌母丨ㄋ丿丶	扌母丨ㄋ丿丶
焖	火门丶ㄋ丶丶	火门丶ㄋ丶丶
聩	耳丨ㄋ丿丶	耳丨ㄋ丿丶
岘	山见丨ㄋ丿ㄋ	山见丨ㄋ丿ㄋ
讧	讠工一丨一一	讠工一丨一一
矽	石歹丿ㄋ丶丶	石歹丿ㄋ丶丶
靛	青定丶丶ㄋ一	青定丶丶ㄋ一
挈	丰刀丿一一丨	丰刀丿一一丨
杷	木巴ㄋ丨一ㄋ	木巴ㄋ丨一ㄋ
笳	加ㄋ丿丨ㄋ	加ㄋ丿丨ㄋ
姒	女以ㄋ丶丿丶	女以ㄋ丶丿丶
菖	艹日丨ㄋ一一	艹日丨ㄋ一一
卟	口卜丨丶丶丶	口卜丨丶丶丶
蚋	虫内丨ㄋ丿丶	虫内丨ㄋ丿丶
袢	衤半丶丿一一	衤半丶丿一一
砉	丰石一丿丨ㄋ	丰石一丿丨ㄋ
踽	笔丨ㄋ一丨	笔丨ㄋ一丨
黾	口日ㄋㄋㄋㄋ	口日ㄋㄋㄋㄋ
挲	氵少丿一一丨	氵少丿一一丨
凫	鸟几丿ㄋㄋㄋ	鸟几丿ㄋㄋㄋ
侩	亻人一一ㄋ丶	亻人一一ㄋ丶
莜	艹亻丿一丿丶	艹亻丿一丿丶
鼋	元口丨ㄋ一一	元口丨ㄋ一一
韪	是韦一一ㄋ丨	是韦一一ㄋ丨
郯	火火ㄋ丨丨丨	火火ㄋ丨丨丨
笪	旦丨ㄋ一一	旦丨ㄋ一一
诔	讠未一一一丨	讠未一一一丨
箸	者一丨一丿	者一丨一丿
菅	艹宀丨ㄋ一ㄋ	艹宀丨ㄋ一ㄋ
裢	衤车丶ㄋ丶丶	衤车丶ㄋ丶丶
趿	及丿ㄋ丶丶	及丿ㄋ丶丶
嵊	山禾丨一一丿	山禾丨一一丿
圜	口四一丨ㄋ一	口四一丨ㄋ一
赍	十从丶ㄋ丨ㄋ	十从丶ㄋ丨ㄋ
涪	氵立丨ㄋ一一	氵立丨ㄋ一一
莠	艹禾ㄋ丿丿丿	艹禾ㄋ丿丿丿
莴	艹口丨ㄋ丿丶	艹口丨ㄋ丿丶
旯	日九丿ㄋㄋㄋ	日九丿ㄋㄋㄋ
阌	门ㄋ丶丶丶	门ㄋ丶丶丶
巽	巴巴一丨丨一	巴巴一丨丨一
跎	宀丿ㄋㄋㄋ	宀丿ㄋㄋㄋ
囵	口仑丿丶丿ㄋ	口仑丿丶丿ㄋ
簟	西丨ㄋ一一	西丨ㄋ一一
柞	木乍丿一丨一	木乍丿一丨一
曷	日勹丿丶ㄋㄋ	日勹丿丶ㄋㄋ
榧	木匚丨一一一	木匚丨一一一
裰	衤双ㄋ丶ㄋ丶	衤双ㄋ丶ㄋ丶
笾	力丶ㄋ丶丶	力丶ㄋ丶丶
嗍	口屰丿ㄋ一一	口屰丿ㄋ一一
绔	纟大一一ㄋㄋ	纟大一一ㄋㄋ
餮	歹人丿丿丿丿	歹人丿丿丿丿
讵	讠匚ㄋ一一一	讠匚ㄋ一一一
魃	鬼石ㄋ丶丶丶	鬼石ㄋ丶丶丶
骓	马隹丿丨丶一	马隹丿丨丶一
逖	犬火丶ㄋ丶丶	犬火丶ㄋ丶丶
镒	金䒑丿丶丨ㄋ	金首丿丶丨ㄋ
枋	木方丶一ㄋ丿	木方丶一ㄋ丿
踅	折口丨一丿丶	折口丨一丿丶
鄢	正与丶丶丶丶	正与丶丶丶丶
瑭	王广ㄋ一一丨	王广ㄋ一一丨
乜	㇉乙ㄋㄋㄋㄋ	Z乙ㄋㄋㄋㄋ
鳟	鱼酋一丨丶丶	鱼酋一丨丶丶
荛	艹尧一ㄋ丿一	艹尧一ㄋ丿一
馓	食共丨ㄋ一一	食共丨ㄋ一一
蟛	虫壴丿丿丿丿	虫壴丿丿丿丿
忪	忄公丿丶ㄋ丶	忄公丿丶ㄋ丶
纰	纟比一ㄋ丿ㄋ	纟比一ㄋ丿ㄋ
姹	女宀丿一ㄋㄋ	女宀丿一ㄋㄋ
桉	木宀ㄋ丿一一	木宀ㄋ丿一一
阍	门氏丨ㄋ一一	门氏丨ㄋ一一
氘	气刂丿丨丨丨	气刂丿丨丨丨
氪	气古丿ㄋㄋㄋ	气古丿ㄋㄋㄋ
娉	女甲一ㄋㄋㄋ	女甲一ㄋㄋㄋ
纡	纟于一一丨丨	纟于一一丨丨
缟	纟丨ㄋ一一	纟丨ㄋ一一
旮	九日丨ㄋ一一	九日丨ㄋ一一
垅	土龙一丿ㄋ丿	土龙一丿ㄋ丿
汊	氵双丶丶丶丶	氵双丶丶丶丶
傈	亻西一丨丿丶	亻西一丨丿丶
郃	合耳ㄋ丨丨丨	合耳ㄋ丨丨丨
镢	金广丶丿一ㄋ	金广丶丿一ㄋ
蔺	艹门丿丨丶一	艹门丿丨丶一
魍	鬼冂丶丿一丶	鬼冂丶丿一丶
腭	月吅一一ㄋㄋ	月吅一一ㄋㄋ
槊	屰月一丨丿丶	屰月一丨丿丶
缁	纟川丨ㄋ一丨	纟川丨ㄋ一丨
鹕	古月丿ㄋ丶ㄋ	古月丿ㄋ丶ㄋ
髂	骨宀丿ㄋ丶丨	骨宀丿ㄋ丶丨
枥	木广ㄋ丿丿丿	木广ㄋ丿丿丿
庥	广亻一丨丿丶	广亻一丨丿丶
笮	乍丿一丨一	乍丿一丨一
堋	土月丿ㄋ一一	土月丿ㄋ一一
跞	留丨丿丶丶	留丨丿丶丶
吒	口笔一ㄋㄋㄋ	口笔一ㄋㄋㄋ
蜍	虫亼一丨丿丶	虫亼一丨丿丶
鹧	度水丿ㄋ丶ㄋ	度水丿ㄋ丶ㄋ
醚	西米丶ㄋ丶丶	西米丶ㄋ丶丶
禳	衤亠丨ㄋ一丨	衤亠丨ㄋ一丨
枳	木口丿丶丶丶	木口丿丶丶丶
舻	舟卜ㄋ一丿丿	舟卜ㄋ一丿丿
鏊	敖金丿丶一一	敖金丿丶一一
搿	手合丿一一丨	手合丿一一丨
钹	金石ㄋ丶丶丶	金石ㄋ丶丶丶
珩	王彳一一丨丨	王彳一一丨丨
蒺	艹疒丿一一丿	艹疒丿一一丿
蜢	虫子丨ㄋ丨丨	虫子丨ㄋ丨丨
鬻	弓米ㄋ一ㄋ一	弓米ㄋ一ㄋ一
骠	马西一一丨丿	马西一一丨丿
菀	艹宀丿ㄋ丶ㄋ	艹宀丿ㄋ丶ㄋ
垭	土亚一丨丨丶	土亚一丨丨丶
瘘	疒米ㄋ丿一一	疒米ㄋ丿一一
苄	艹笔一丨丶丶	艹笔一丨丶丶
苕	艹刀丨ㄋ一一	艹刀丨ㄋ一一
跹	舌丶ㄋ丶丶	舌丶ㄋ丶丶
卮	广笔ㄋㄋㄋㄋ	广笔ㄋㄋㄋㄋ
袷	衤合丿丶一丨	衤合丿丶一丨
磬	土尸丿ㄋㄋ丶	土尸丿ㄋㄋ丶
鸷	扌执丿ㄋ丶ㄋ	扌执丿ㄋ丶ㄋ
缶	缶丿一一丨ㄋ	缶丿一一丨ㄋ
笸	匚丨ㄋ一一	匚丨ㄋ一一
纨	纟九丶丶丶丶	纟九丶丶丶丶
琮	王宀一一丨丿	王宀一一丨丿
蕲	艹单丿丿一丨	艹单丿丿一丨
牦	牛毛丿一一ㄋ	牛毛丿一一ㄋ
阆	门笔ㄋ一一ㄋ	门笔ㄋ一一ㄋ
郓	冖车ㄋ丨丨丨	冖车ㄋ丨丨丨
蠲	䒑八丨ㄋ丨丨	首八丨ㄋ丨丨
锒	金笔ㄋ一一ㄋ	金笔ㄋ一一ㄋ
芰	艹十ㄋ丶丶丶	艹十ㄋ丶丶丶
锕	金耳一丨ㄋ一	金耳一丨ㄋ一
砩	石弓丿丨丨丨	石弓丿丨丨丨
驷	马口丿ㄋㄋㄋ	马口丿ㄋㄋㄋ
舢	舟山丨ㄋ丨丨	舟山丨ㄋ丨丨
妯	女甲丨ㄋ一丨	女甲丨ㄋ一丨
趸	力口丨一丿丶	力口丨一丿丶
鹩	大冫丨ㄋ一一	大冫丨ㄋ一一
蠊	虫广丶丿一ㄋ	虫广丶丿一ㄋ
芫	艹元丿ㄋㄋㄋ	艹元丿ㄋㄋㄋ
笊	爪丿丿丨丶	爪丿丿丨丶
嗉	口丰ㄋㄋ丶丨	口丰ㄋㄋ丶丨
焱	火火丶丿丿丶	火火丶丿丿丶
枇	木比一ㄋ丿ㄋ	木比一ㄋ丿ㄋ
饴	食厶丨ㄋ一一	食厶丨ㄋ一一
阃	门口一丨丿丶	门口一丨丿丶
莸	艹犬一丿ㄋㄋ	艹犬一丿ㄋㄋ
浯	氵五丨ㄋ一一	氵五丨ㄋ一一
擤	扌自丨ㄋ一丨	扌自丨ㄋ一丨
铆	金留丿ㄋ丿ㄋ	金留丿ㄋ丿ㄋ
柢	木氏丶丶丶丶	木氏丶丶丶丶
醢	西石丨ㄋ一丨	西石丨ㄋ一丨
呲	口此丨一丨一	口此丨一丨一
牖	片户一丨ㄋ一	片户一丨ㄋ一
鬣	长川丨ㄋ一丿	长川丨ㄋ一丿
碓	石隹丿丨丶一	石隹丿丨丶一
帙	巾笔一一丿丶	巾笔一一丿丶
堀	土尸ㄋ丨丨ㄋ	土尸ㄋ丨丨ㄋ
溆	氵亼一丨丿丶	氵亼一丨丿丶
潴	氵犬一丨一丿	氵犬一丨一丿
鹆	八人丨ㄋ一丿	八人丨ㄋ一丿
硪	石我丿一丨一	石我丿一丨一
雱	方丶一ㄋ丿	方丶一ㄋ丿
崾	山西ㄋ丿一一	山西ㄋ丿一一
箝	扌一丨丨一	扌一丨丨一
幂	冖日一丿丶丶	冖日一丿丶丶
獐	犬音一丨丨丨	犬音一丨丨丨
桁	木彳一一丨丨	木彳一一丨丨
鳏	鱼四丨丿丿丶	鱼四丨丿丿丶
郴	林耳ㄋ丨丨丨	林耳ㄋ丨丨丨
蛱	虫夹丿丶丶丶	虫夹丿丶丶丶
疝	疒山丨ㄋ丨丨	疒山丨ㄋ丨丨
诎	讠山ㄋ丨丨丨	讠山ㄋ丨丨丨
僳	亻西丶丿一丨	亻西丶丿一丨
茴	艹回丨ㄋ丨ㄋ	艹回丨ㄋ丨ㄋ
呦	口幺ㄋ丿丿丿	口幺ㄋ丿丿丿
揶	扌耳ㄋ丨丨丨	扌耳ㄋ丨丨丨
囹	口令丿丶丶ㄋ	口令丿丶丶ㄋ
脲	月尸丨ㄋ丿丶	月尸丨ㄋ丿丶
螈	虫广丿丨ㄋ一	虫广丿丨ㄋ一
嗌	口䒑丿丶丨ㄋ	口首丿丶丨ㄋ
贽	执贝丨ㄋ丿丶	执贝丨ㄋ丿丶
痼	疒口一丨丨ㄋ	疒口一丨丨ㄋ
镊	金耳ㄋ丶ㄋ丶	金耳ㄋ丶ㄋ丶
膈	月鬲一丨ㄋ一	月鬲一丨ㄋ一
赅	贝亥丶一ㄋ丿	贝亥丶一ㄋ丿
锑	金弓丶丿ㄋ一	金弓丶丿ㄋ一
鳊	鱼户丨ㄋ一丨	鱼户丨ㄋ一丨
胨	月车丨丿丶丶	月车丨丿丶丶
桡	木尧一ㄋ丿一	木尧一ㄋ丿一
鼬	鼠甲丨ㄋ一丨	鼠甲丨ㄋ一丨
雎	目隹丿丨丶一	目隹丿丨丶一
鞫	革勹丶一一一	革勹丶一一一
峄	山双一一丨丨	山双一一丨丨
鲋	鱼亻一丨丶丶	鱼亻一丨丶丶
苤	艹不一一一一	艹不一一一一
昀	日勹丶一一一	日勹丶一一一
痍	疒大ㄋ一ㄋㄋ	疒大ㄋ一ㄋㄋ
疖	疒卩ㄋ丨丨丨	疒卩ㄋ丨丨丨
蟊	矛虫丨ㄋ一丨	矛虫丨ㄋ一丨
熘	火留丨ㄋ一丨	火留丨ㄋ一丨
鞴	革共丿丿ㄋ一	革共丿丿ㄋ一
獯	犬舌丨ㄋ丶丿	犬舌丨ㄋ丶丿
鹂	丽鸟丿ㄋ丶ㄋ	丽鸟丿ㄋ丶ㄋ
炷	火主丶一一丨	火主丶一一丨
裾	衤尸一丨丨ㄋ	衤尸一丨丨ㄋ
羸	赢羊丶丿一一	赢羊丶丿一一
栀	木广一ㄋㄋㄋ	木广一ㄋㄋㄋ
侪	亻文丿丨丨丨	亻文丿丨丨丨
硐	石冂一丨ㄋ一	石冂一丨ㄋ一
槲	木角丶丶一丨	木角丶丶一丨
嵴	山水丿丶丨ㄋ	山水丿丶丨ㄋ
炝	火人ㄋㄋㄋㄋ	火人ㄋㄋㄋㄋ
锸	金舌丿丨一ㄋ	金舌丿丨一ㄋ
乇	笔七一ㄋㄋㄋ	笔七一ㄋㄋㄋ
佰	亻笔丿丨ㄋ一	亻笔丿丨ㄋ一
哔	口比一丨丨丨	口比一丨丨丨
牯	牛古一丨丨ㄋ	牛古一丨丨ㄋ
旆	族笔丨ㄋ丨丨	族笔丨ㄋ丨丨
掾	扌彑丿ㄋ丿丿	扌彑丿ㄋ丿丿
珐	王去一丨一ㄋ	王去一丨一ㄋ
屙	尸耳一丨ㄋ一	尸耳一丨ㄋ一
僦	亻京一丿ㄋ丶	亻京一丿ㄋ丶
钪	金亠丿ㄋㄋㄋ	金亠丿ㄋㄋㄋ
仟	亻舌丿一丨丨	亻舌丿一丨丨
廪	广亠丨ㄋ丨ㄋ	广亠丨ㄋ丨ㄋ
擘	辟手丿一一丨	辟手丿一一丨
跗	亻一丨丶丶	亻一丨丶丶
圮	土巴ㄋ一ㄋㄋ	土巴ㄋ一ㄋㄋ
崃	山夹丨丿丶丶	山夹丨丿丶丶
芟	艹殳丿ㄋㄋ丶	艹殳丿ㄋㄋ丶
鲅	鱼石ㄋ丶丶丶	鱼石ㄋ丶丶丶
笱	勹丨ㄋ一一	勹丨ㄋ一一
彀	笔ㄋ一ㄋ丿	笔ㄋ一ㄋ丿
硷	石亼丶丶丿一	石亼丶丶丿一
圄	口五丨ㄋ一一	口五丨ㄋ一一
苎	艹宀一一一一	艹宀一一一一
匏	大二ㄋ丿ㄋㄋ	大二ㄋ丿ㄋㄋ
嗾	口族丿一一丿	口族丿一一丿
赧	赤卩ㄋ丶丶丶	赤卩ㄋ丶丶丶
玳	王亻一ㄋ丶丶	王亻一ㄋ丶丶
掴	扌口一一丨一	扌口一一丨一
勐	子四ㄋ丿丿丿	子四ㄋ丿丿丿
愍	民文丶ㄋ丶丶	民文丶ㄋ丶丶
粳	米更一丨ㄋ一	米更一丨ㄋ一
畛	田人丿丿丿丿	田人丿丿丿丿
涑	氵束一丨ㄋ一	氵束一丨ㄋ一
卣	卜口ㄋ一一一	卜口ㄋ一一一
浞	氵口丨一丿丶	氵口丨一丿丶
逦	丽辶丶ㄋ丶丶	丽辶丶ㄋ丶丶
箧	匚一丶丿一	匚一丶丿一
铄	金留丨丿丶丶	金留丨丿丶丶
貉	豸各丿ㄋ丶丨	豸各丿ㄋ丶丨
湫	氵禾丶丿丿丶	氵禾丶丿丿丶
椴	木段丿丨一一	木段丿丨一一
擀	扌丿丶一一	扌丿丶一一
刖	月刂丨丨丨丨	月刂丨丨丨丨
鲮	鱼土丿丶丿ㄋ	鱼土丿丶丿ㄋ
茱	艹笔丨丿丶丶	艹笔丨丿丶丶
啖	口火丶丿丿丶	口火丶丿丿丶
畈	田广ㄋ丶丶丶	田广ㄋ丶丶丶
悭	忄一丨一一	忄一丨一一
訇	勹讠丶一一一	勹讠丶一一一
愀	忄禾丶丿丿丶	忄禾丶丿丿丶
朐	月勹丨ㄋ一一	月勹丨ㄋ一一
鹨	羽人丿丿丿丿	羽人丿丿丿丿
蛘	虫羊丶丿一一	虫羊丶丿一一
晟	日戊ㄋㄋㄋㄋ	日戊ㄋㄋㄋㄋ
佶	亻吉一丨一丨	亻吉一丨一丨
颛	山一丿丨ㄋ	山一丿丨ㄋ
缃	纟相一丨丿丶	纟相一丨丿丶
凼	水冂ㄋ丨丨丨	水冂ㄋ丨丨丨
鲱	鱼非丨一一一	鱼非丨一一一
苴	艹目丨ㄋ一一	艹目丨ㄋ一一
徉	彳羊丶丿一一	彳羊丶丿一一
癯	疒目丨ㄋ一一	疒目丨ㄋ一一
洙	氵笔丨丿丶丶	氵笔丨丿丶丶
锆	金告丿一丨一	金告丿一丨一
厍	广车一ㄋ一丨	广车一ㄋ一丨
佤	亻瓦一ㄋㄋ丶	亻瓦一ㄋㄋ丶
鞒	革天丿丨丨丨	革天丿丨丨丨
氡	气文丶丶丶丶	气文丶丶丶丶
胗	月人丿丿丿丿	月人丿丿丿丿
螭	虫㐫丨ㄋㄋ丶	虫离丨ㄋㄋ丶
钺	金戊一ㄋㄋ丿	金戊一ㄋㄋ丿
繇	爪缶丿ㄋㄋ丶	爪缶丿ㄋㄋ丶
勰	力力ㄋ丿丨ㄋ	力力ㄋ丿丨ㄋ
嵬	山鬼丿丨ㄋ一	山鬼丿丨ㄋ一
邨	屯耳ㄋ丨丨丨	屯耳ㄋ丨丨丨
轸	车人丿丿丿丿	车人丿丿丿丿
瘿	疒贝丨ㄋ丿丶	疒贝丨ㄋ丿丶
肫	月屯一ㄋ丨ㄋ	月屯一ㄋ丨ㄋ
肟	月二ㄋㄋㄋㄋ	月二ㄋㄋㄋㄋ
睇	目弓丶丿ㄋ一	目弓丶丿ㄋ一
仞	亻刀丶丶丶丶	亻刀丶丶丶丶
蝼	虫米ㄋ丿一一	虫米ㄋ丿一一
奁	大区一丿丶ㄋ	大区一丿丶ㄋ
跆	厶丨ㄋ一一	厶丨ㄋ一一
轳	车卜ㄋ一丿丿	车卜ㄋ一丿丿
樗	木一一ㄋㄋ	木一一ㄋㄋ
钼	金目丨ㄋ一一	金目丨ㄋ一一
熳	火日丨ㄋ丨丨	火日丨ㄋ丨丨
宄	宀九丿ㄋㄋㄋ	宀九丿ㄋㄋㄋ
鲰	鱼耳ㄋ丶丶丶	鱼耳ㄋ丶丶丶
诶	讠厶丿一一丿	讠厶丿一一丿
薜	艹辟ㄋ一丿丨	艹辟ㄋ一丿丨
铧	金化一丨丨丨	金化一丨丨丨
裥	衤门丨ㄋ一一	衤门丨ㄋ一一
榇	木立一丨丿丶	木立一丨丿丶
馃	食日一丨丿丶	食日一丨丿丶
怄	忄区一丿丶ㄋ	忄区一丿丶ㄋ
雠	隹讠丿丨丶一	隹讠丿丨丶一
鸱	氏笔丿ㄋ丶ㄋ	氏笔丿ㄋ丶ㄋ
寤	宀片一丨ㄋ一	宀片一丨ㄋ一
虺	笔儿丨ㄋ一丨	笔儿丨ㄋ一丨
糅	米矛一丨丿丶	米矛一丨丿丶
缗	纟民丨ㄋ一一	纟民丨ㄋ一一
蹚	一丨一一	一丨一一
帑	奴巾丨ㄋ丨丨	奴巾丨ㄋ丨丨
矬	矢从一丨一一	矢从一丨一一
硗	石尧一ㄋ丿一	石尧一ㄋ丿一
镧	金门一丨ㄋ一	金门一丨ㄋ一
碡	石丰ㄋㄋ丶一	石丰ㄋㄋ丶一
悒	忄口ㄋ丨一ㄋ	忄口ㄋ丨一ㄋ
啁	口冂一丨一丨	口冂一丨一丨
艉	舟尸丿一一ㄋ	舟尸丿一一ㄋ
犍	牛聿ㄋ丶丶丶	牛聿ㄋ丶丶丶
硌	石各丿ㄋ丶丨	石各丿ㄋ丶丨
虿	力虫丨ㄋ一丨	力虫丨ㄋ一丨
埙	土口丨ㄋ丿丶	土口丨ㄋ丿丶
锩	金ㄋㄋㄋㄋ	金ㄋㄋㄋㄋ
蛑	虫厶丿一一丨	虫厶丿一一丨
鼍	吅田一丨ㄋ一	吅田一丨ㄋ一
筮	工丿丶丿丶	工丿丶丿丶
艏	舟䒑丿丨ㄋ一	舟首丿丨ㄋ一
肄	七矢ㄋ一一一	七矢ㄋ一一一
糁	米厶丿丿丿丿	米厶丿丿丿丿
咴	口石丶丿丿丶	口石丶丿丿丶
骜	敖马ㄋㄋ一一	敖马ㄋㄋ一一
蜮	虫戋丨ㄋ一一	虫戋丨ㄋ一一
黢	黑厶丿丶丿ㄋ	黑厶丿丶丿ㄋ
砻	龙石一丿丨ㄋ	龙石一丿丨ㄋ
籴	入米丶丿一丨	入米丶丿一丨
龀	止七丿ㄋㄋㄋ	止七丿ㄋㄋㄋ
劢	力力ㄋ丿丿丿	力力ㄋ丿丿丿
鲲	鱼日一ㄋ丿ㄋ	鱼日一ㄋ丿ㄋ
稞	禾日一丨丿丶	禾日一丨丿丶
鬯	乂水ㄋ丨丿ㄋ	乂水ㄋ丨丿ㄋ
畚	厶田丨ㄋ一丨	厶田丨ㄋ一丨
觳	笔丿ㄋ丿ㄋ	笔丿ㄋ丿ㄋ
鹁	子丿ㄋ丶ㄋ	子丿ㄋ丶ㄋ
耪	未立丶一ㄋ丿	未立丶一ㄋ丿
娆	女尧一ㄋ丿一	女尧一ㄋ丿一
捌	扌口ㄋ丿丨丨	扌口ㄋ丿丨丨
柘	木石一丿丨ㄋ	木石一丿丨ㄋ
篪	广丨一ㄋ丿	广丨一ㄋ丿
鲀	鱼屯一ㄋ丨ㄋ	鱼屯一ㄋ丨ㄋ
獬	犬角ㄋ丿丿一	犬角ㄋ丿丿一
菔	艹月ㄋ丨丨丨	艹月ㄋ丨丨丨
闫	门三一一一一	门三一一一一
滟	氵丰丿ㄋㄋ丨	氵丰丿ㄋㄋ丨
狎	犬甲丨ㄋ一一	犬甲丨ㄋ一一
孬	不女ㄋ丨一一	不女ㄋ丨一一
遒	酋辶丶ㄋ丶丶	酋辶丶ㄋ丶丶
磔	石歹一ㄋ丨一	石歹一ㄋ丨一
齑	文刂丨一一一	文刂丨一一一
綦	其糸ㄋㄋ丶丨	其糸ㄋㄋ丶丨
伥	亻长丿一ㄋ丶	亻长丿一ㄋ丶
聃	耳冂一丨一一	耳冂一丨一一
谰	讠门一丨ㄋ一	讠门一丨ㄋ一
鲡	鱼丽一丨ㄋ丶	鱼丽一丨ㄋ丶
谇	讠亠丿丶丿丶	讠亠丿丶丿丶
鄄	西土ㄋ丨丨丨	西土ㄋ丨丨丨
蔻	艹宀一一丿ㄋ	艹宀一一丿ㄋ
泠	氵令丿丶丶ㄋ	氵令丿丶丶ㄋ
镫	金一丨ㄋ一	金祭一丨ㄋ一
钕	金女ㄋ丿一一	金女ㄋ丿一一
砗	石车一ㄋ一丨	石车一ㄋ一丨
佥	亼丶丶丿一	亼丶丶丿一
躅	四丿ㄋ丨ㄋ	四丿ㄋ丨ㄋ
螯	敖虫丨ㄋ一丨	敖虫丨ㄋ一丨
煅	火段丿丨一一	火段丿丨一一
鲠	鱼更一丨ㄋ一	鱼更一丨ㄋ一
菹	落目丨ㄋ一一	落目丨ㄋ一一
罘	四不一丿丨丶	四不一丿丨丶
煸	火户丨ㄋ一丨	火户丨ㄋ一丨
胂	月日丨丨丨丨	月日丨丨丨丨
嶝	山一丨ㄋ一	山祭一丨ㄋ一
坨	土宀丿ㄋㄋㄋ	土宀丿ㄋㄋㄋ
灞	氵一丨丨一	氵一丨丨一
踯	䒑一丿丶ㄋ	首一丿丶ㄋ
哞	口厶丿一一丨	口厶丿一一丨
徜	彳丨ㄋ丨ㄋ	彳丨ㄋ丨ㄋ
萘	艹大一一丨丿	艹大一一丨丿
鸫	车小丿ㄋ丶ㄋ	车小丿ㄋ丶ㄋ
菽	艹上丨丿丶ㄋ	艹上丨丿丶ㄋ
縻	麻糸ㄋㄋ丶丨	麻糸ㄋㄋ丶丨
渑	氵口丨ㄋ一一	氵口丨ㄋ一一
褫	衤广丨一ㄋ丿	衤广丨一ㄋ丿
盍	去四丨ㄋ丨丨	去四丨ㄋ丨丨
慊	忄兼丶丿一ㄋ	忄兼丶丿一ㄋ
羰	羊山一丿丿丿	羊山一丿丿丿
洳	氵女丨ㄋ一一	氵女丨ㄋ一一
钋	金卜丨丶丶丶	金卜丨丶丶丶
俅	亻求一丨丶一	亻求一丨丶一
镛	金广ㄋ一一丨	金广ㄋ一一丨
洮	氵儿丶一丿丶	氵儿丶一丿丶
罴	四去丶丶丶丶	四去丶丶丶丶
怛	忄旦丨ㄋ一一	忄旦丨ㄋ一一
隳	耳石一丨一丿	耳石一丨一丿
胼	月䒑一丿丨丨	月首一丿丨丨
芤	艹子ㄋㄋㄋㄋ	艹子ㄋㄋㄋㄋ
芊	艹舌丿一丨丨	艹舌丿一丨丨
膻	月亠丨ㄋ丨ㄋ	月亠丨ㄋ丨ㄋ
噌	口曾丶丿丨ㄋ	口曾丶丿丨ㄋ
嫱	女十丶丿一丨	女十丶丿一丨
啉	口林一丨丿丶	口林一丨丿丶
焐	火五丨ㄋ一一	火五丨ㄋ一一
绲	纟日一ㄋ丿ㄋ	纟日一ㄋ丿ㄋ
蘅	艹彳丿ㄋ丨ㄋ	艹彳丿ㄋ丨ㄋ
亓	笔兀一丿丨丨	笔兀一丿丨丨
莼	艹纟一ㄋ丨ㄋ	艹纟一ㄋ丨ㄋ
嘞	口革ㄋ丿丿丿	口革ㄋ丿丿丿
缒	纟笔丨ㄋ一ㄋ	纟笔丨ㄋ一ㄋ
倮	亻日一丨丿丶	亻日一丨丿丶
镆	金莫一丨丨丨	金莫一丨丨丨
葎	艹彳ㄋ一一一	艹彳ㄋ一一一
韫	韦日丨ㄋ丨丨	韦日丨ㄋ丨丨
荏	荷王丿一丨一	荷王丿一丨一
伧	亻人ㄋㄋㄋㄋ	亻人ㄋㄋㄋㄋ
鸶	幺幺一丿ㄋ丶	幺幺一丿ㄋ丶
唳	口户一丿丶丶	口户一丿丶丶
蘖	艹笔丨ㄋ一ㄋ	艹笔丨ㄋ一ㄋ
澍	氵壴一丨丶丶	氵壴一丨丶丶
蚬	虫见丨ㄋ丿ㄋ	虫见丨ㄋ丿ㄋ
檩	木亠丨ㄋ丨ㄋ	木亠丨ㄋ丨ㄋ
颎	七火一丿丨ㄋ	七火一丿丨ㄋ
骱	骨人丿丨丨丨	骨人丿丨丨丨
羧	羊厶丿丶丿ㄋ	羊厶丿丶丿ㄋ
鼙	壴十ㄋ丶丿丨	壴十ㄋ丶丿丨
焯	火卜丨ㄋ一一	火卜丨ㄋ一一
怙	忄古一丨丨ㄋ	忄古一丨丨ㄋ
腚	月定丶丶ㄋ一	月定丶丶ㄋ一
垡	亻戋一丨一一	亻戋一丨一一
嘏	古叚ㄋ一丨一	古叚ㄋ一丨一
魈	鬼丨ㄋ一一	鬼丨ㄋ一一
亳	笔一ㄋㄋㄋ	笔一ㄋㄋㄋ
荠	艹文丿丨丨丨	艹文丿丨丨丨
昴	日留丿ㄋ丿ㄋ	日留丿ㄋ丿ㄋ
倥	亻穴一丨一一	亻穴一丨一一
艽	艹九丿ㄋㄋㄋ	艹九丿ㄋㄋㄋ
舨	舟广ㄋ丶丶丶	舟广ㄋ丶丶丶
粜	山冂丶丿一丨	山冂丶丿一丨
枵	木口一ㄋㄋㄋ	木口一ㄋㄋㄋ
醣	西广ㄋ一一丨	西广ㄋ一一丨
杓	木勹丶丶丶丶	木勹丶丶丶丶
茔	萝土一丨一一	萝土一丨一一
珲	王冖一ㄋ一丨	王冖一ㄋ一丨
楸	木禾丶丿丿丶	木禾丶丿丿丶
疃	田立丨ㄋ一一	田立丨ㄋ一一
髌	骨宀丿丨一丨	骨宀丿丨一丨
甙	戋甘一丨丨一	戋甘一丨丨一
楦	木宀一丨ㄋ一	木宀一丨ㄋ一
蛏	虫双一丨一一	虫双一丨一一
蠛	虫萝一丿ㄋ丿	虫萝一丿ㄋ丿
钣	金广ㄋ丶丶丶	金广ㄋ丶丶丶
笄	开一一丿丨	开一一丿丨
嬖	辟女ㄋ丿一一	辟女ㄋ丿一一
跣	先丿一丨一	先丿一丨一
蜣	虫羊丿ㄋㄋㄋ	虫羊丿ㄋㄋㄋ
诼	讠豕丶丶丶丶	讠豕丶丶丶丶
蜉	虫爪ㄋ丨一一	虫爪ㄋ丨一一
戆	音十丿ㄋ丶一	音十丿ㄋ丶一
铍	金皮ㄋ丿丨ㄋ	金皮ㄋ丿丨ㄋ
喾	告丿一丨一	告丿一丨一
薹	艹吉丶ㄋ一ㄋ	艹吉丶ㄋ一ㄋ
陉	耳轻ㄋ丶一丨	耳轻ㄋ丶一丨
瓴	令瓦一ㄋㄋ丶	令瓦一ㄋㄋ丶
岵	山古一丨丨ㄋ	山古一丨丨ㄋ
肷	月欠丿ㄋ丿丶	月欠丿ㄋ丿丶
怫	忄弓丿丨丨丨	忄弓丿丨丨丨
缯	纟曾丶丿丨ㄋ	纟曾丶丿丨ㄋ
荽	艹爪ㄋ丿一一	艹爪ㄋ丿一一
钭	金冫一丨丨丨	金冫一丨丨丨
窀	穴屯一ㄋ丨ㄋ	穴屯一ㄋ丨ㄋ
帔	巾皮ㄋ丿丨ㄋ	巾皮ㄋ丿丨ㄋ
楝	木束丶丶丶丶	木束丶丶丶丶
摭	扌度丶丶丶丶	扌度丶丶丶丶
痱	疒非丨一一一	疒非丨一一一
髑	骨四丿ㄋ丨ㄋ	骨四丿ㄋ丨ㄋ
蚶	虫甘一丨丨一	虫甘一丨丨一
倬	亻卜丨ㄋ一一	亻卜丨ㄋ一一
螬	虫笔丨ㄋ一丨	虫笔丨ㄋ一丨
萋	艹笔ㄋ一一丨	艹笔ㄋ一一丨
殛	歹了丨ㄋ一ㄋ	歹了丨ㄋ一ㄋ
狷	犬口丨ㄋ一一	犬口丨ㄋ一一
葭	艹叚ㄋ一丨一	艹叚ㄋ一丨一
衽	衤王丿一丨一	衤王丿一丨一
鳢	鱼甲一丨ㄋ一	鱼甲一丨ㄋ一
粝	米广一ㄋ丿丿	米广一ㄋ丿丿
鼗	儿水一丨一丨	儿水一丨一丨
裉	衤艮ㄋ一一ㄋ	衤艮ㄋ一一ㄋ
喁	口日丨ㄋ丨一	口日丨ㄋ丨一
傧	亻宀丿丨一丨	亻宀丿丨一丨
蝽	虫丨ㄋ一一	虫丨ㄋ一一
罟	四古一丨丨ㄋ	四古一丨丨ㄋ
愦	忄丨ㄋ丿丶	忄丨ㄋ丿丶
裼	衤日丿ㄋ丿丿	衤日丿ㄋ丿丿
钌	金了ㄋ丨丨丨	金了ㄋ丨丨丨
嫘	女田ㄋㄋ丶丨	女田ㄋㄋ丶丨
衿	衤令丿丶丶ㄋ	衤令丿丶丶ㄋ
墉	土广ㄋ一一丨	土广ㄋ一一丨
锗	金者一丨一丿	金者一丨一丿
哌	口广丿ㄋ丿丶	口广丿ㄋ丿丶
廛	广田丿丶一丨	广田丿丶一丨
醵	西虍一丿ㄋ丿	西虍一丿ㄋ丿
跫	工几丶丨ㄋ一	工几丶丨ㄋ一
粢	次米丶丿一丨	次米丶丿一丨
鐾	辟金丿丶一一	辟金丿丶一一
堇	堇一丨丨一丨	堇一丨丨一丨
婧	女青一一丨一	女青一一丨一
蹰	广一丨ㄋ一	广一丨ㄋ一
陟	耳止丨丿丿丿	耳止丨丿丿丿
镞	金族丿一一丿	金族丿一一丿
扦	扌舌丿一丨丨	扌舌丿一丨丨
暌	日一一丿丶	日祭一一丿丶
脘	月宀一一丿ㄋ	月宀一一丿ㄋ
鳔	鱼西一一丨丿	鱼西一一丨丿
罱	四十丨ㄋ丶丿	四十丨ㄋ丶丿
唿	口勿丶ㄋ丶丶	口勿丶ㄋ丶丶
薨	萝冖一丿ㄋ丶	萝冖一丿ㄋ丶
麸	丰文一一丿丶	丰文一一丿丶
岿	山刂ㄋ一一一	山刂ㄋ一一一
疴	疒可一丨ㄋ一	疒可一丨ㄋ一
侔	亻厶丿一一丨	亻厶丿一一丨
郾	匚日ㄋ丿一ㄋ	匚日ㄋ丿一ㄋ
砹	石艹丿丶丶丶	石艹丿丶丶丶
眦	目此丨一丨一	目此丨一丨一
猢	犬古丿ㄋ一一	犬古丿ㄋ一一
璎	王贝丨ㄋ丿丶	王贝丨ㄋ丿丶
撺	扌穴丨ㄋ一丨	扌穴丨ㄋ一丨
铳	金亡丿ㄋㄋㄋ	金亡丿ㄋㄋㄋ
拊	扌亻一丨丶丶	扌亻一丨丶丶
鳚	鱼尸一一丨丿	鱼尸一一丨丿
狯	犬人一一ㄋ丶	犬人一一ㄋ丶
滁	氵耳丿丶一一	氵耳丿丶一一
椁	木ㄋ丨一一	木ㄋ丨一一
偾	亻十一丨丨丨	亻十一丨丨丨
裎	衤口一一丨一	衤口一一丨一
罾	四曾丶丿丨ㄋ	四曾丶丿丨ㄋ
榱	木一丿ㄋ丿	木一丿ㄋ丿
呒	口笔一丿ㄋㄋ	口笔一丿ㄋㄋ
缇	纟是丨ㄋ一一	纟是丨ㄋ一一
蝣	虫族ㄋ丨一一	虫族ㄋ丨一一
崞	山ㄋ丨一一	山ㄋ丨一一
狲	犬子丨丿丶丶	犬子丨丿丶丶
缱	纟丨ㄋ一ㄋ	纟丨ㄋ一ㄋ
冼	冫先丿一丨一	冫先丿一丨一
晷	日文丨丶丶丶	日文丨丶丶丶
痧	疒氵丨丿丶丿	疒氵丨丿丶丿
萑	艹隹丿丨丶一	艹隹丿丨丶一
帏	巾韦一一ㄋ丨	巾韦一一ㄋ丨
蕖	落匚一ㄋㄋㄋ	落匚一ㄋㄋㄋ
疠	疒力一ㄋ丿丿	疒力一ㄋ丿丿
儋	亻厃丿丶丶一	亻厃丿丶丶一
窨	穴音丶一丶丿	穴音丶一丶丿
狍	犬勹ㄋ一ㄋㄋ	犬勹ㄋ一ㄋㄋ
绨	纟弓丶丿ㄋ一	纟弓丶丿ㄋ一
憷	忄林ㄋ丨一丿	忄林ㄋ丨一丿
锛	金大一丨一丿	金大一丨一丿
袼	衤各丿ㄋ丶丨	衤各丿ㄋ丶丨
汜	氵巴ㄋ一ㄋㄋ	氵巴ㄋ一ㄋㄋ
邰	厶口ㄋ丨丨丨	厶口ㄋ丨丨丨
蘩	艹ㄋㄋ丶一	艹ㄋㄋ丶一
窳	穴爪丿丿ㄋ丶	穴爪丿丿ㄋ丶
瓠	大二ㄋ丿丿ㄋ	大二ㄋ丿丿ㄋ
炅	日火丶丿丿丶	日火丶丿丿丶
虮	虫几丿ㄋㄋㄋ	虫几丿ㄋㄋㄋ
蚰	虫甲丨ㄋ一丨	虫甲丨ㄋ一丨
煳	火古丿ㄋ一一	火古丿ㄋ一一
嵝	山米ㄋ丿一一	山米ㄋ丿一一
庀	广七丿ㄋㄋㄋ	广七丿ㄋㄋㄋ
泶	水丨ㄋ丿丶	水丨ㄋ丿丶
蹉	羊一丨一一	羊一丨一一
砀	石㇉丿丿丿丿	石Z丿丿丿丿
莪	艹我丿一丨一	艹我丿一丨一
捩	扌户一丿丶丶	扌户一丿丶丶
螽	文冫丨ㄋ一丨	文冫丨ㄋ一丨
苊	艹广ㄋㄋㄋㄋ	艹广ㄋㄋㄋㄋ
犸	犬马ㄋㄋ一一	犬马ㄋㄋ一一
蘼	艹麻丨一一一	艹麻丨一一一
曛	日舌丨ㄋ丶丿	日舌丨ㄋ丶丿
鹾	卜口丿丶丶丿	卜口丿丶丶丿
隹	隹丿丨丶一一	隹丿丨丶一一
衄	笔四ㄋ丨一一	笔四ㄋ丨一一
蛲	虫尧一ㄋ丿一	虫尧一ㄋ丿一
槔	木白一丿丶一	木白一丿丶一
辊	车日一ㄋ丿ㄋ	车日一ㄋ丿ㄋ
泫	氵亠ㄋㄋ丶丶	氵亠ㄋㄋ丶丶
墀	土尸丨丶一丿	土尸丨丶一丿
玢	王分丿丶ㄋ丿	王分丿丶ㄋ丿
酐	西舌一一丨丨	西舌一一丨丨
瞋	目直丿丶丶丶	目直丿丶丶丶
銎	工几丶丿丶一	工几丶丿丶一
噻	口寒一丨一一	口寒一丨一一
猗	犬大一丨ㄋ一	犬大一丨ㄋ一
嚯	口丿丨丶一	口丿丨丶一
堞	土甘ㄋ一丨丿	土甘ㄋ一丨丿
逑	求辶丶ㄋ丶丶	求辶丶ㄋ丶丶
硖	石夹丿丶丶丶	石夹丿丶丶丶
畀	田丨ㄋ一丨一	田丨ㄋ一丨一
尥	尢勹丶丶丶丶	尢勹丶丶丶丶
嵛	山亼丨ㄋ一一	山亼丨ㄋ一一
逯	尹水丶ㄋ丶丶	尹水丶ㄋ丶丶
鲃	鱼巴ㄋ丨一ㄋ	鱼巴ㄋ丨一ㄋ
溧	氵西一丨丿丶	氵西一丨丿丶
嫒	女一丿ㄋ丶	女一丿ㄋ丶
鄞	堇耳ㄋ丨丨丨	堇耳ㄋ丨丨丨
黧	禾勹丿丨ㄋ丶	禾勹丿丨ㄋ丶
沆	氵亠丿ㄋㄋㄋ	氵亠丿ㄋㄋㄋ
鹈	弓鸟丿ㄋ丶ㄋ	弓鸟丿ㄋ丶ㄋ
呖	口广ㄋ丿丿丿	口广ㄋ丿丿丿
谵	讠厃丿丶丶一	讠厃丿丶丶一
缣	纟兼丶丿一ㄋ	纟兼丶丿一ㄋ
塬	土广丿丨ㄋ一	土广丿丨ㄋ一
偬	亻勿丶丶ㄋ丶	亻勿丶丶ㄋ丶
窭	穴米ㄋ丿一一	穴米ㄋ丿一一
嬲	田力ㄋ丿一ㄋ	田力ㄋ丿一ㄋ
肭	月内丨ㄋ丿丶	月内丨ㄋ丿丶
篯	金一一ㄋ丿	金一一ㄋ丿
鹱	鸟艹丿丨丶一	鸟艹丿丨丶一
喱	口广丨ㄋ一一	口广丨ㄋ一一
赀	此贝丨ㄋ丿丶	此贝丨ㄋ丿丶
铋	金心丿丿丿丿	金心丿丿丿丿
曩	日亠丨ㄋ一丨	日亠丨ㄋ一丨
溘	氵去丨ㄋ丨丨	氵去丨ㄋ丨丨
箪	单丶丿丨ㄋ	单丶丿丨ㄋ
裣	衤亼丶丶丿一	衤亼丶丶丿一
秫	禾木丶丶丶丶	禾木丶丶丶丶
蒌	艹米ㄋ丿一一	艹米ㄋ丿一一
泔	氵甘一丨丨一	氵甘一丨丨一
酃	吅丨ㄋ一ㄋ	吅丨ㄋ一ㄋ
朊	月二丿ㄋㄋㄋ	月二丿ㄋㄋㄋ
迕	十丶ㄋ丶丶	十丶ㄋ丶丶
仫	亻笔ㄋ丶丶丶	亻笔ㄋ丶丶丶
鳙	鱼广ㄋ一一丨	鱼广ㄋ一一丨
鬟	长四一丨ㄋ一	长四一丨ㄋ一
挹	扌口ㄋ丨一ㄋ	扌口ㄋ丨一ㄋ
盱	目于一一丨丨	目于一一丨丨
钎	金舌丿一丨丨	金舌丿一丨丨
悱	忄非丨一一一	忄非丨一一一
胙	月乍丿一丨一	月乍丿一丨一
捭	扌卑丿丨ㄋ一	扌卑丿丨ㄋ一
芑	艹巴ㄋ一ㄋㄋ	艹巴ㄋ一ㄋㄋ
糇	米亻ㄋ一丿一	米亻ㄋ一丿一
欹	大可丿ㄋ丿丶	大可丿ㄋ丿丶
瞽	壴十ㄋ丶丨ㄋ	壴十ㄋ丶丨ㄋ
甾	川田丨ㄋ一丨	川田丨ㄋ一丨
鹪	隹水丿ㄋ丶ㄋ	隹水丿ㄋ丶ㄋ
崤	山乂一丿丿ㄋ	山乂一丿丿ㄋ
澶	氵亠丨ㄋ丨ㄋ	氵亠丨ㄋ丨ㄋ
铯	金鱼ㄋ丨一ㄋ	金鱼ㄋ丨一ㄋ
缡	纟㐫丨ㄋㄋ丶	纟离丨ㄋㄋ丶
钇	金乙ㄋㄋㄋㄋ	金乙ㄋㄋㄋㄋ
鞔	革象丿ㄋㄋㄋ	革象丿ㄋㄋㄋ
鲚	鱼文丿丨丨丨	鱼文丿丨丨丨
玎	王于一丨丨丨	王于一丨丨丨
猊	犬鼠丿ㄋㄋㄋ	犬鼠丿ㄋㄋㄋ
阊	门日丨ㄋ一一	门日丨ㄋ一一
嘬	口日一丨丨一	口日一丨丨一
锜	金大一丨ㄋ一	金大一丨ㄋ一
湔	氵前丶丿一丨	氵前丶丿一丨
籼	米山丨ㄋ丨丨	米山丨ㄋ丨丨
燹	豕豕丶丿丿丶	豕豕丶丿丿丶
庹	度尺ㄋ一丿丶	度尺ㄋ一丿丶
舾	舟西一丨ㄋ丿	舟西一丨ㄋ丿
渖	氵宀丨ㄋ一一	氵宀丨ㄋ一一
锊	金爪一丨丶丶	金爪一丨丶丶
祕	衤心丿丿丿丿	衤心丿丿丿丿
甯	宀心丨ㄋ一一	宀心丨ㄋ一一
蓼	艹羽丿丶丿丿	艹羽丿丶丿丿
瑷	王一丿ㄋ丶	王一丿ㄋ丶
钯	金巴ㄋ丨一ㄋ	金巴ㄋ丨一ㄋ
幛	巾音一丨丨丨	巾音一丨丨丨
篦	丿丶一一	丿丶一一
褊	衤户丨ㄋ一丨	衤户丨ㄋ一丨
葑	艹圭一丨丶丶	艹圭一丨丶丶
癔	疒音丶ㄋ丶丶	疒音丶ㄋ丶丶
麇	鹿禾一丨丿丶	鹿禾一丨丿丶
蚍	虫比一ㄋ丿ㄋ	虫比一ㄋ丿ㄋ
浼	氵象丿ㄋㄋㄋ	氵象丿ㄋㄋㄋ
樘	木一丨一一	木一丨一一
锼	金鼠丨丨丨丨	金鼠丨丨丨丨
岣	山勹丨ㄋ一一	山勹丨ㄋ一一
穸	穴歹丿ㄋ丶丶	穴歹丿ㄋ丶丶
敫	白方丿一丿丶	白方丿一丿丶
铒	金耳一丨丨一	金耳一丨丨一
钫	金方丶一ㄋ丿	金方丶一ㄋ丿
钔	金门丶丨ㄋㄋ	金门丶丨ㄋㄋ
锿	金丿ㄋ丿丶	金丿ㄋ丿丶
嵯	山羊一丨一一	山羊一丨一一
泮	氵半丶丿一一	氵半丶丿一一
瀣	氵卜丿ㄋ丶ㄋ	氵卜丿ㄋ丶ㄋ
戗	人巴一ㄋ丿丶	人巴一ㄋ丿丶
皴	厶八丿ㄋ丶ㄋ	厶八丿ㄋ丶ㄋ
轫	车刀丶丶丶丶	车刀丶丶丶丶
睃	目厶丿丶丿ㄋ	目厶丿丶丿ㄋ
遄	山而丶ㄋ丶丶	山而丶ㄋ丶丶
逭	宀吅丶ㄋ丶丶	宀吅丶ㄋ丶丶
莩	艹爪ㄋ丨一一	艹爪ㄋ丨一一
篁	白一一丨一	白一一丨一
醍	西是丨ㄋ一一	西是丨ㄋ一一
锱	金川丨ㄋ一丨	金川丨ㄋ一丨
褰	寒衣丶一丿ㄋ	寒衣丶一丿ㄋ
葚	艹其ㄋㄋㄋㄋ	艹其ㄋㄋㄋㄋ
炱	厶口丶丿丿丶	厶口丶丿丿丶
睥	目卑丿丨ㄋ一	目卑丿丨ㄋ一
驽	奴马ㄋㄋ一一	奴马ㄋㄋ一一
辚	车米丿ㄋ丶一	车米丿ㄋ丶一
驺	马刍丿ㄋㄋ一	马刍丿ㄋㄋ一
筇	工ㄋ丨丨丨	工ㄋ丨丨丨
髀	骨卑丿丨ㄋ一	骨卑丿丨ㄋ一
戥	日生一ㄋ丿丶	日生一ㄋ丿丶
鸺	亻木丿ㄋ丶ㄋ	亻木丿ㄋ丶ㄋ
眇	目少丨丿丶丿	目少丨丿丶丿
楮	木者一丨一丿	木者一丨一丿
迓	牙辶丶ㄋ丶丶	牙辶丶ㄋ丶丶
哙	口人一一ㄋ丶	口人一一ㄋ丶
逄	文㐄丶ㄋ丶丶	文年丶ㄋ丶丶
濞	氵自丨ㄋ一丨	氵自丨ㄋ一丨
桤	木山ㄋ一ㄋㄋ	木山ㄋ一ㄋㄋ
磙	石六ㄋ丶丿ㄋ	石六ㄋ丶丿ㄋ
疳	广甘一丨丨一	广甘一丨丨一
砜	石几丿丶丶丶	石几丿丶丶丶
炻	火石一丿丨ㄋ	火石一丿丨ㄋ
鹮	四鬲丿ㄋ丿丶	四鬲丿ㄋ丿丶
醭	西业丶丿一一	西业丶丿一一
鳇	鱼白一一丨一	鱼白一一丨一
唢	口丨ㄋ丿丶	口丨ㄋ丿丶
仡	亻ㄋㄋㄋㄋ	亻ㄋㄋㄋㄋ
醐	西古丿ㄋ一一	西古丿ㄋ一一
菘	艹木丿丶丶丶	艹木丿丶丶丶
殳	殳丿ㄋㄋ丶丶	殳丿ㄋㄋ丶丶
獍	犬音丿ㄋㄋㄋ	犬音丿ㄋㄋㄋ
栌	木卜ㄋ一丿丿	木卜ㄋ一丿丿
馇	食木丨ㄋ一一	食木丨ㄋ一一
祢	衤尔丿ㄋ丨丿	衤尔丿ㄋ丨丿
暝	日冖丨ㄋ一一	日冖丨ㄋ一一
磴	石一丨ㄋ一	石祭一丨ㄋ一
搴	寒手丿一一丨	寒手丿一一丨
尕	乃小丨丿丶丶	乃小丨丿丶丶
殄	歹人丿丿丿丿	歹人丿丿丿丿
豉	豆十ㄋ丶丶丶	豆十ㄋ丶丶丶
湓	氵分丨ㄋ丨丨	氵分丨ㄋ丨丨
垴	土㐫丶一丿丶	土离丶一丿丶
薅	艹女一丿丿丿	艹女一丿丿丿
刿	山歹丨丨丨丨	山歹丨丨丨丨
锝	金日一一丨丶	金日一一丨丶
葜	艹丰ㄋ丿一丿	艹丰ㄋ丿一丿
艚	舟笔丨ㄋ一丨	舟笔丨ㄋ一丨
镅	金尸丨ㄋ一一	金尸丨ㄋ一一
黼	业米丿一丿丶	业米丿一丿丶
蹀	甘ㄋ一丨丿	甘ㄋ一丨丿
蟥	虫共丨ㄋ一丨	虫共丨ㄋ一丨
瓿	立口一ㄋㄋ丶	立口一ㄋㄋ丶
氙	气山丨ㄋ丨丨	气山丨ㄋ丨丨
铑	金者丿ㄋㄋㄋ	金者丿ㄋㄋㄋ
煺	火艮丶ㄋ丶丶	火艮丶ㄋ丶丶
踟	矢丨ㄋ一一	矢丨ㄋ一一
鲷	鱼冂一丨一丨	鱼冂一丨一丨
膂	族衣丨ㄋ一一	族衣丨ㄋ一一
杪	木少丨丿丶丿	木少丨丿丶丿
砬	石立丶一丶丿	石立丶一丶丿
蒡	艹立丶一ㄋ丿	艹立丶一ㄋ丿
酽	西亚丿丿丿丿	西亚丿丿丿丿
蒴	艹屰丿ㄋ一一	艹屰丿ㄋ一一
硭	石艹丶一ㄋㄋ	石艹丶一ㄋㄋ
肜	月川丿丿丿丿	月川丿丿丿丿
猡	犬四丿ㄋ丶丶	犬四丿ㄋ丶丶
藁	艹丨ㄋ一一	艹丨ㄋ一一
漯	氵田ㄋㄋ丶丨	氵田ㄋㄋ丶丨
皤	白釆丨ㄋ一丨	白釆丨ㄋ一丨
旒	族亡丿丨ㄋㄋ	族亡丿丨ㄋㄋ
殍	歹爪ㄋ丨一一	歹爪ㄋ丨一一
哏	口艮ㄋ一一ㄋ	口艮ㄋ一一ㄋ
锍	金亡丿丨ㄋㄋ	金亡丿丨ㄋㄋ
鞲	革共丨ㄋ一丨	革共丨ㄋ一丨
硇	石丿丶一一	石丿丶一一
哿	加可一丨ㄋ一	加可一丨ㄋ一
姝	女笔丨丿丶丶	女笔丨丿丶丶
镬	金艹丿丨丶一	金艹丿丨丶一
茭	艹六丿丶丶丶	艹六丿丶丶丶
喹	口大一丨一一	口大一丨一一
溏	氵广ㄋ一一丨	氵广ㄋ一一丨
畋	田文丿一丿丶	田文丿一丿丶
鲔	鱼石丨ㄋ一一	鱼石丨ㄋ一一
鸲	勹口丿ㄋ丶ㄋ	勹口丿ㄋ丶ㄋ
窆	穴笔丶ㄋ丶丶	穴笔丶ㄋ丶丶
跶	大丶ㄋ丶丶	大丶ㄋ丶丶
谂	讠令丶ㄋ丶丶	讠令丶ㄋ丶丶
髟	长一丨一一一	长一丨一一一
橥	犬者一丨丿丶	犬者一丨丿丶
赉	夹来丨ㄋ丿丶	夹来丨ㄋ丿丶
骘	耳止丨丿丿ㄋ	耳止丨丿丿ㄋ
羼	尸羊丶丿一一	尸羊丶丿一一
缧	纟田ㄋㄋ丶丨	纟田ㄋㄋ丶丨
镓	金宀一丿ㄋ丿	金宀一丿ㄋ丿
窬	穴亼丨ㄋ一一	穴亼丨ㄋ一一
吣	口心丶ㄋ丶丶	口心丶ㄋ丶丶
邳	不笔ㄋ丨丨丨	不笔ㄋ丨丨丨
溲	氵鼠丨ㄋ丶丶	氵鼠丨ㄋ丶丶
筌	人一一丨一	人一一丨一
孥	奴子ㄋ丨一一	奴子ㄋ丨一一
璩	王虍一丿ㄋ丿	王虍一丿ㄋ丿
敉	米文丿一丿丶	米文丿一丿丶
鸸	而鸟丿ㄋ丶ㄋ	而鸟丿ㄋ丶ㄋ
涠	氵口一一ㄋ丨	氵口一一ㄋ丨
苒	艹冂一丨一一	艹冂一丨一一
垓	土亥丶一ㄋ丿	土亥丶一ㄋ丿
脔	亦内丿丶丶丶	亦内丿丶丶丶
荸	艹ㄋ丨一一	艹ㄋ丨一一
艟	舟立丨ㄋ一一	舟立丨ㄋ一一
甓	辟瓦一ㄋㄋ丶	辟瓦一ㄋㄋ丶
锪	金勿丶ㄋ丶丶	金勿丶ㄋ丶丶
镄	金弓丿丨丨ㄋ	金弓丿丨丨ㄋ
眬	目龙一丿ㄋ丿	目龙一丿ㄋ丿
旄	族毛丿一一ㄋ	族毛丿一一ㄋ
彘	彑七丿一一丿	彑七丿一一丿
檠	芍口丿一丿丶	芍口丿一丿丶
祆	衤天丿一丿丶	衤天丿一丿丶
胩	月上丨丶丶丶	月上丨丶丶丶
啰	口四丿ㄋ丶丶	口四丿ㄋ丶丶
芠	艹文丶一丿丶	艹文丶一丿丶
柒	氵七一丨丿丶	氵七一丨丿丶
珉	王民ㄋ一ㄋ一	王民ㄋ一ㄋ一
镔	金宀丿丨一丨	金宀丿丨一丨
霈	氵一丨ㄋ丨	氵一丨ㄋ丨
惇	忄ㄋ丨一一	忄ㄋ丨一一
菡	艹了丶一丿丶	艹了丶一丿丶
棹	木卜丨ㄋ一一	木卜丨ㄋ一一
糗	米自一丿丶丶	米自一丿丶丶
绡	纟丨ㄋ一一	纟丨ㄋ一一
囗	口丨ㄋ一一一	口丨ㄋ一一一
妤	女矛ㄋ丶ㄋ丨	女矛ㄋ丶ㄋ丨
玟	王文丶一丿丶	王文丶一丿丶
孑	子ㄋ丨一一一	子ㄋ丨一一一
箐	青一一丨一	青一一丨一
嫫	女莫一丨丨丨	女莫一丨丨丨
爿	片ㄋ丨一丿丿	片ㄋ丨一丿丿
葳	艹戊一ㄋ丿一	艹戊一ㄋ丿一
婠	女宀丨ㄋ一ㄋ	女宀丨ㄋ一ㄋ
嫚	女日丨ㄋ丨丨	女日丨ㄋ丨丨
螓	虫一丨丿丶	虫一丨丿丶
箬	艹一丿丨ㄋ	艹一丿丨ㄋ
扞	扌舌一一丨丨	扌舌一一丨丨
荑	艹大ㄋ一ㄋㄋ	艹大ㄋ一ㄋㄋ
葶	艹一丨丨丨	艹一丨丨丨
姮	女笔丨ㄋ一一	女笔丨ㄋ一一
珅	王日丨丨丨丨	王日丨丨丨丨
塆	土亦ㄋ一ㄋㄋ	土亦ㄋ一ㄋㄋ
岙	天山丨ㄋ丨丨	天山丨ㄋ丨丨
辂	车各丿ㄋ丶丨	车各丿ㄋ丶丨
珣	王勹丨ㄋ一一	王勹丨ㄋ一一
猱	犬矛一丨丿丶	犬矛一丨丿丶
仝	人工一丨一一	人工一丨一一
獒	敖犬一丿丶丶	敖犬一丿丶丶
濛	氵萝一一丿ㄋ	氵萝一一丿ㄋ
潋	氵亼丶丶丿一	氵亼丶丶丿一
酡	西宀丿ㄋㄋㄋ	西宀丿ㄋㄋㄋ
茛	艹艮ㄋ一一ㄋ	艹艮ㄋ一一ㄋ
瑗	王爪一一丿ㄋ	王爪一一丿ㄋ
阚	门㇉一丨丨一	门Z一丨丨一
郜	告耳ㄋ丨丨丨	告耳ㄋ丨丨丨
蓁	艹一丨丿丶	艹一丨丿丶
埭	土尹丨丶一丿	土尹丨丶一丿
轾	车至一ㄋ丶一	车至一ㄋ丶一
搦	扌弓丶一ㄋ一	扌弓丶一ㄋ一
跖	石一丿丨ㄋ	石一丿丨ㄋ
眙	目厶丨ㄋ一一	目厶丨ㄋ一一
垸	土宀一一丿ㄋ	土宀一一丿ㄋ
邡	方耳ㄋ丨丨丨	方耳ㄋ丨丨丨
骢	马丿丶一丶	马丿丶一丶
睚	目广一丨一一	目广一丨一一
玥	王月丿ㄋ一一	王月丿ㄋ一一
搠	扌屰丿ㄋ一一	扌屰丿ㄋ一一
樨	木尸丨丶一丿	木尸丨丶一丿
珪	王圭一丨一一	王圭一丨一一
滘	氵冖丿丶一丨	氵冖丿丶一丨
戢	口耳一ㄋ丿丶	口耳一ㄋ丿丶
垟	土羊丶丿一一	土羊丶丿一一
麴	十人丿ㄋ丶丿	十人丿ㄋ丶丿
徼	彳白丶一ㄋ丿	彳白丶一ㄋ丿
荦	萝牛丿一一丨	萝牛丿一一丨
骝	马留丨ㄋ一丨	马留丨ㄋ一丨
郗	乂巾ㄋ丨丨丨	乂巾ㄋ丨丨丨
扃	户冂丨ㄋ一一	户冂丨ㄋ一一
沭	氵木丶丶丶丶	氵木丶丶丶丶
骐	马其一丨丨一	马其一丨丨一
屦	尸彳丶丿一丨	尸彳丶丿一丨
矞	矛冂丿丶丨ㄋ	矛冂丿丶丨ㄋ
剡	火火丨丨丨丨	火火丨丨丨丨
蓣	艹矛一丿丨ㄋ	艹矛一丿丨ㄋ
铙	金尧一ㄋ丿一	金尧一ㄋ丿一
骖	马厶丿丿丿丿	马厶丿丿丿丿
臌	月壴一丨ㄋ丶	月壴一丨ㄋ丶
钲	金正一丨一丨	金正一丨一丨
豸	豸丿丶丶丿ㄋ	豸丿丶丶丿ㄋ
瑄	王宀一丨ㄋ一	王宀一丨ㄋ一
芘	艹比一ㄋ丿ㄋ	艹比一ㄋ丿ㄋ
毵	厶川丿一一ㄋ	厶川丿一一ㄋ
哚	口几一丨丿丶	口几一丨丿丶
吲	口弓丨丨丨丨	口弓丨丨丨丨
镗	金一丨一一	金一丨一一
蕈	艹西丨ㄋ一一	艹西丨ㄋ一一
襦	衤一丿丨ㄋ	衤一丿丨ㄋ
腈	月青一一丨一	月青一一丨一
舄	鼠勹丶丶丶丶	鼠勹丶丶丶丶
疋	走ㄋ丨一丿丶	走ㄋ丨一丿丶
訾	此讠丶一一一	此讠丶一一一
蓍	艹者丿ㄋ丨ㄋ	艹者丿ㄋ丨ㄋ
栊	木龙一丿ㄋ丿	木龙一丿ㄋ丿
屣	尸彳丨一丨一	尸彳丨一丨一
爨	鼠冂一丨ㄋ一	鼠冂一丨ㄋ一
脩	亻文丿ㄋ一一	亻文丿ㄋ一一
傕	亻冖丿丨丶一	亻冖丿丨丶一
郄	乂石ㄋ丶ㄋ丨	乂石ㄋ丶ㄋ丨
嶷	山七丿一一丿	山七丿一一丿
埚	土口丨ㄋ丿丶	土口丨ㄋ丿丶
仵	亻一丨丨丨	亻一丨丨丨
鳐	鱼爪丿一一丨	鱼爪丿一一丨
茕	萝乙一丨丨丨	萝乙一丨丨丨
邾	笔未ㄋ丨丨丨	笔未ㄋ丨丨丨
蘧	艹虍一丿ㄋ丿	艹虍一丿ㄋ丿
萏	艹鱼丿丨一ㄋ	艹鱼丿丨一ㄋ
珰	王ㄋ一一一	王ㄋ一一一
趱	走先丿一丨一	走先丿一丨一
徂	彳目丨ㄋ一一	彳目丨ㄋ一一
耋	者七一ㄋ丶一	者七一ㄋ丶一
塍	月一丨一一	月一丨一一
蕤	艹豕丿一一丨	艹豕丿一一丨
耒	未一一一丨丿	未一一一丨丿
橼	木纟ㄋㄋ一丿	木纟ㄋㄋ一丿
柰	木示一一丨丿	木示一一丨丿
檗	辟木一丨丿丶	辟木一丨丿丶
垆	土卜ㄋ一丿丿	土卜ㄋ一丿丿
菰	艹子丿丿ㄋ丶	艹子丿丿ㄋ丶
圉	口土丶丿一一	口土丶丿一一
麈	鹿主丶一一丨	鹿主丶一一丨
翮	鬲羽ㄋ丶一ㄋ	鬲羽ㄋ丶一ㄋ
彧	戋口一丿丿丿	戋口一丿丿丿
秾	禾农丶ㄋ丿ㄋ	禾农丶ㄋ丿ㄋ
襞	辟衣丶一丿ㄋ	辟衣丶一丿ㄋ
兕	吅儿丿ㄋㄋㄋ	吅儿丿ㄋㄋㄋ
邗	舌耳ㄋ丨丨丨	舌耳ㄋ丨丨丨
帻	巾丰丨ㄋ丿丶	巾丰丨ㄋ丿丶
晞	日乂丨ㄋ丨丨	日乂丨ㄋ丨丨
欷	乂巾丿ㄋ丿丶	乂巾丿ㄋ丿丶
哓	口尧一ㄋ丿一	口尧一ㄋ丿一
坼	土丘丶丶丶丶	土丘丶丶丶丶
纛	丰母一ㄋ一一	丰母一ㄋ一一
踬	广一丨丨ㄋ	广一丨丨ㄋ
坩	土甘一丨丨一	土甘一丨丨一
腩	月十丨ㄋ丶丿	月十丨ㄋ丶丿
嬛	女四一丨ㄋ一	女四一丨ㄋ一
慝	匚艹一丿丶ㄋ	匚艹一丿丶ㄋ
柙	木甲丨ㄋ一一	木甲丨ㄋ一一
蠃	赢虫丨ㄋ一丨	赢虫丨ㄋ一丨
隈	耳田一ㄋ丿丶	耳田一ㄋ丿丶
箜	穴一丨一一	穴一丨一一
荜	艹比一丨丨丨	艹比一丨丨丨
狺	犬讠丶一一一	犬讠丶一一一
燠	火丶丿一丨	火丶丿一丨
坻	土氏丶丶丶丶	土氏丶丶丶丶
溷	氵口一丿ㄋ丿	氵口一丿ㄋ丿
篌	亻ㄋ一丿一	亻ㄋ一丿一
昝	文卜丨ㄋ一一	文卜丨ㄋ一一
嗐	口宀一一一丨	口宀一一一丨
玕	王舌一一丨丨	王舌一一丨丨
伛	亻区一丿丶ㄋ	亻区一丿丶ㄋ
绂	纟石ㄋ丶丶丶	纟石ㄋ丶丶丶
湜	氵是丨ㄋ一一	氵是丨ㄋ一一
荇	艹彳一一丨丨	艹彳一一丨丨
栲	木者一ㄋㄋㄋ	木者一ㄋㄋㄋ
眄	目正ㄋㄋㄋㄋ	目正ㄋㄋㄋㄋ
暾	日ㄋ丨一丿	日ㄋ丨一丿
棻	艹分一丨丿丶	艹分一丨丿丶
炆	火文丶一丿丶	火文丶一丿丶
莳	艹日一丨丶丶	艹日一丨丶丶
侑	亻石丨ㄋ一一	亻石丨ㄋ一一
鳉	鱼北丿ㄋ丶一	鱼北丿ㄋ丶一
纮	纟石ㄋ丶丶丶	纟石ㄋ丶丶丶
镝	金立丨ㄋ一丨	金立丨ㄋ一丨
瞵	目米丿ㄋ丶一	目米丿ㄋ丶一
觜	此角丿ㄋ丿ㄋ	此角丿ㄋ丿ㄋ
筲	丨ㄋ一一	丨ㄋ一一
撄	扌贝丨ㄋ丿丶	扌贝丨ㄋ丿丶
貔	豸丿丶一一	豸丿丶一一
蓊	艹公ㄋ丶一ㄋ	艹公ㄋ丶一ㄋ
秭	禾弓丶丿ㄋ一	禾弓丶丿ㄋ一
翥	者者一丨一丿	者者一丨一丿
蹓	留丨ㄋ一丨	留丨ㄋ一丨
桷	木角丿ㄋ丿ㄋ	木角丿ㄋ丿ㄋ
砑	石牙一ㄋ丨丿	石牙一ㄋ丨丿
陬	耳耳ㄋ丶丶丶	耳耳ㄋ丶丶丶
喆	吉吉一丨一丨	吉吉一丨一丨
槃	舟殳一丨丿丶	舟殳一丨丿丶
垌	土冂一丨ㄋ一	土冂一丨ㄋ一
坭	土尸丿ㄋㄋㄋ	土尸丿ㄋㄋㄋ
雩	二ㄋㄋㄋㄋ	二ㄋㄋㄋㄋ
璟	王日丶一丨ㄋ	王日丶一丨ㄋ
屌	尸口丨ㄋ丨丨	尸口丨ㄋ丨丨
贶	贝口丿ㄋㄋㄋ	贝口丿ㄋㄋㄋ
瘗	疒夹丿丶一丨	疒夹丿丶一丨
絜	丰刀ㄋㄋ丶丨	丰刀ㄋㄋ丶丨
絷	执糸ㄋㄋ丶丨	执糸ㄋㄋ丶丨
罍	田田丨ㄋ一丨	田田丨ㄋ一丨
珙	王共一丨丨一	王共一丨丨一
琚	王尸一丨丨ㄋ	王尸一丨丨ㄋ
酹	西爪一丨丶丶	西爪一丨丶丶
飏	几乂ㄋ丿丿丿	几乂ㄋ丿丿丿
犴	犬舌一一丨丨	犬舌一一丨丨
觚	角爪丿丿ㄋ丶	角爪丿丿ㄋ丶
歃	舌鼠丿ㄋ丿丶	舌鼠丿ㄋ丿丶
尻	尸九丿ㄋㄋㄋ	尸九丿ㄋㄋㄋ
酲	西口一一丨一	西口一一丨一
鳜	鱼广丶丿一ㄋ	鱼广丶丿一ㄋ
蝾	虫萝一丨丿丶	虫萝一丨丿丶
毳	毛毛丿一一ㄋ	毛毛丿一一ㄋ
鲽	鱼甘ㄋ一丨丿	鱼甘ㄋ一丨丿
貅	豸亻一丨丿丶	豸亻一丨丿丶
髫	长刀丨ㄋ一一	长刀丨ㄋ一一
沔	氵正ㄋㄋㄋㄋ	氵正ㄋㄋㄋㄋ
鬲	鬲一丨ㄋ一丨	鬲一丨ㄋ一丨
刳	大二ㄋ丨丨丨	大二ㄋ丨丨丨
黥	黑京丶一丨ㄋ	黑京丶一丨ㄋ
鲙	鱼人一一ㄋ丶	鱼人一一ㄋ丶
棰	木垂丿一丨一	木垂丿一丨一
禊	衤丰ㄋ丿一丿	衤丰ㄋ丿一丿
颡	双双一丨丿丶	双双一丨丿丶
鲭	鱼青一一丨一	鱼青一一丨一
觇	占见丨ㄋ丿ㄋ	占见丨ㄋ丿ㄋ
骀	马厶丨ㄋ一一	马厶丨ㄋ一一
柽	木双一丨一一	木双一丨一一
颙	日内一丿丨ㄋ	日内一丿丨ㄋ
棼	林分丿丶ㄋ丿	林分丿丶ㄋ丿
杌	木笔丿ㄋㄋㄋ	木笔丿ㄋㄋㄋ
妁	女勹丶丶丶丶	女勹丶丶丶丶
巯	轻亡丿丨ㄋㄋ	轻亡丿丨ㄋㄋ
泺	氵留丨丿丶丶	氵留丨丿丶丶
觌	十㇉丶丶一丿	十Z丶丶一丿
捽	扌亠丿丶丿丶	扌亠丿丶丿丶
堠	土亻ㄋ一丿一	土亻ㄋ一丿一
埒	土爪一丨丶丶	土爪一丨丶丶
鲵	鱼鼠丿ㄋㄋㄋ	鱼鼠丿ㄋㄋㄋ
幪	巾萝一一丿ㄋ	巾萝一一丿ㄋ
萜	艹巾丨一丨ㄋ	艹巾丨一丨ㄋ
葸	艹田丶ㄋ丶丶	艹田丶ㄋ丶丶
吖	口冫丨丨丨丨	口冫丨丨丨丨
桴	木爪ㄋ丨一一	木爪ㄋ丨一一
谮	讠旡一ㄋ丿ㄋ	讠旡一ㄋ丿ㄋ
湲	氵爪一一丿ㄋ	氵爪一一丿ㄋ
跂	十ㄋ丶丶丶	十ㄋ丶丶丶
茆	艹留丿ㄋ丿ㄋ	艹留丿ㄋ丿ㄋ
蓐	艹辰一丨丶丶	艹辰一丨丶丶
椹	木其ㄋㄋㄋㄋ	木其ㄋㄋㄋㄋ
柝	木丘丶丶丶丶	木丘丶丶丶丶
岈	山牙一ㄋ丨丿	山牙一ㄋ丨丿
踣	立丨ㄋ一一	立丨ㄋ一一
蒹	艹兼丶丿一ㄋ	艹兼丶丿一ㄋ
舁	鼠开一丿丨丨	鼠开一丿丨丨
毽	毛聿ㄋ丶丶丶	毛聿ㄋ丶丶丶
妣	女比一ㄋ丿ㄋ	女比一ㄋ丿ㄋ
禛	衤直丿丶丶丶	衤直丿丶丶丶
怍	忄乍丿一丨一	忄乍丿一丨一
埝	土令丶ㄋ丶丶	土令丶ㄋ丶丶
醅	西立丨ㄋ一一	西立丨ㄋ一一
磻	石釆丨ㄋ一丨	石釆丨ㄋ一丨
埕	土口一一丨一	土口一一丨一
圯	土巴ㄋ一ㄋㄋ	土巴ㄋ一ㄋㄋ
鲳	鱼日丨ㄋ一一	鱼日丨ㄋ一一
膦	月米丿ㄋ丶一	月米丿ㄋ丶一
燊	火火丶丿丿丶	火火丶丿丿丶
莨	艹笔ㄋ一一ㄋ	艹笔ㄋ一一ㄋ
苾	艹心丿丿丿丿	艹心丿丿丿丿
藨	艹鹿丶丶丶丶	艹鹿丶丶丶丶
殂	歹目丨ㄋ一一	歹目丨ㄋ一一
铖	金戊ㄋㄋㄋㄋ	金戊ㄋㄋㄋㄋ
眚	生目丨ㄋ一一	生目丨ㄋ一一
硚	石天丿丨丨丨	石天丿丨丨丨
鲉	鱼甲丨ㄋ一丨	鱼甲丨ㄋ一丨
呣	口母ㄋㄋ丶一	口母ㄋㄋ丶一
摽	扌西一一丨丿	扌西一一丨丿
缑	纟亻ㄋ一丿一	纟亻ㄋ一丿一
铊	金宀丿ㄋㄋㄋ	金宀丿ㄋㄋㄋ
骎	马尹丶ㄋㄋ丶	马尹丶ㄋㄋ丶
縠	笔ㄋㄋ丶丨	笔ㄋㄋ丶丨
悛	忄厶丿丶丿ㄋ	忄厶丿丶丿ㄋ
怿	忄双一一丨丨	忄双一一丨丨
拶	扌川丿ㄋ丶丶	扌川丿ㄋ丶丶
窅	穴目丨ㄋ一一	穴目丨ㄋ一一
旻	日文丶一丿丶	日文丶一丿丶
玠	王人丿丨丨丨	王人丿丨丨丨
遘	共冂一丨一丶	共冂一丨一丶
蔌	艹束丿ㄋ丿丶	艹束丿ㄋ丿丶
辋	车冂丶丿一丶	车冂丶丿一丶
翛	亻文ㄋ丶一ㄋ	亻文ㄋ丶一ㄋ
狨	犬戋一丿丿丿	犬戋一丿丿丿
绐	纟厶丨ㄋ一一	纟厶丨ㄋ一一
叻	口力ㄋ丿丿丿	口力ㄋ丿丿丿
糨	米弓丨ㄋ一丨	米弓丨ㄋ一丨
悫	几丶ㄋ丶丶	几丶ㄋ丶丶
祧	衤儿丶一丿丶	衤儿丶一丿丶
瑱	王直丿丶丶丶	王直丿丶丶丶
媵	月ㄋ丿一一	月ㄋ丿一一
猁	犬禾丨丨丨丨	犬禾丨丨丨丨
狴	犬比一丨一一	犬比一丨一一
鸮	口丂丿ㄋ丶ㄋ	口丂丿ㄋ丶ㄋ
柁	木宀丿ㄋㄋㄋ	木宀丿ㄋㄋㄋ
砼	石人一丨一一	石人一丨一一
祓	衤石ㄋ丶丶丶	衤石ㄋ丶丶丶
圹	土广丶一丿丿	土广丶一丿丿
娈	亦女ㄋ丿一一	亦女ㄋ丿一一
隰	耳日ㄋㄋ丶丶	耳日ㄋㄋ丶丶
阼	耳乍丿一丨一	耳乍丿一丨一
崄	巾亼丶丶丿一	巾亼丶丶丿一
浥	氵口ㄋ丨一ㄋ	氵口ㄋ丨一ㄋ
炘	火丘丿丿一丨	火丘丿丿一丨
犇	牛牛丿一一丨	牛牛丿一一丨
碁	其石一丿丨ㄋ	其石一丿丨ㄋ
垱	土ㄋ一一一	土ㄋ一一一
箨	扌ㄋ丶一一	扌ㄋ丶一一
郫	卑耳ㄋ丨丨丨	卑耳ㄋ丨丨丨
茀	艹弓丿丨丨丨	艹弓丿丨丨丨
轺	车刀丨ㄋ一一	车刀丨ㄋ一一
侉	亻大一一ㄋㄋ	亻大一一ㄋㄋ
廨	广角ㄋ丿丿一	广角ㄋ丿丿一
铌	金尸丿ㄋㄋㄋ	金尸丿ㄋㄋㄋ
桄	木光丨丶丿一	木光丨丶丿一
昃	日广丿丶丶丶	日广丿丶丶丶
囷	口禾一丨丿丶	口禾一丨丿丶
簋	艮丨ㄋ丨丨	艮丨ㄋ丨丨
甍	萝冖一ㄋㄋ丶	萝冖一ㄋㄋ丶
薤	艹歹丨一一一	艹歹丨一一一
蚺	虫冂一丨一一	虫冂一丨一一
纻	纟宀一一一一	纟宀一一一一
椟	木十ㄋ丶丶一	木十ㄋ丶丶一
岍	山开一一丿丨	山开一一丿丨
揎	扌宀一丨ㄋ一	扌宀一丨ㄋ一
黻	业米一丿ㄋ丶	业米一丿ㄋ丶
酤	西古一丨丨ㄋ	西古一丨丨ㄋ
貊	豸笔丿丨ㄋ一	豸笔丿丨ㄋ一
陔	耳亥丶一ㄋ丿	耳亥丶一ㄋ丿
鹢	䒑八丨ㄋ丨丨	首八丨ㄋ丨丨
烝	了水一丶丶丶	了水一丶丶丶
燋	火隹丶丶丶丶	火隹丶丶丶丶
矇	目艹一丨丨丨	目艹一丨丨丨
瘌	疒束丨丨丨丨	疒束丨丨丨丨
衒	彳亠ㄋㄋ丶一	彳亠ㄋㄋ丶一
蜩	虫冂一丨一丨	虫冂一丨一丨
秕	禾比一ㄋ丿ㄋ	禾比一ㄋ丿ㄋ
纩	纟广丶一丿丿	纟广丶一丿丿
摅	扌虍丶ㄋ丶丶	扌虍丶ㄋ丶丶
邴	丙人ㄋ丨丨丨	丙人ㄋ丨丨丨
醑	西走丨ㄋ一一	西走丨ㄋ一一
亶	亠回丨ㄋ一一	亠回丨ㄋ一一
佺	亻人一一丨一	亻人一一丨一
聱	敖耳一丨丨一	敖耳一丨丨一
俜	亻甲一ㄋㄋㄋ	亻甲一ㄋㄋㄋ
猞	犬亼一丨丨ㄋ	犬亼一丨丨ㄋ
绠	纟更一丨ㄋ一	纟更一丨ㄋ一
绖	纟至一ㄋ丶一	纟至一ㄋ丶一
镪	金弓丨ㄋ一一	金弓丨ㄋ一一
喈	口比丿丨ㄋ一	口比丿丨ㄋ一
蓥	萝金丿丶一一	萝金丿丶一一
栳	木者丿ㄋㄋㄋ	木者丿ㄋㄋㄋ
溽	氵辰一丨丶丶	氵辰一丨丶丶
悃	忄口一丨丿丶	忄口一丨丿丶
堙	土西一丨一一	土西一丨一一
赪	赤卜丨ㄋ丿丶	赤卜丨ㄋ丿丶
褙	衤北丨ㄋ一一	衤北丨ㄋ一一
鲊	鱼乍丿一丨一	鱼乍丿一丨一
瞀	矛文丨ㄋ一一	矛文丨ㄋ一一
畤	田土一丨丶丶	田土一丨丶丶
彿	彳弓丿丨丨丨	彳弓丿丨丨丨
萁	艹其一丨丨一	艹其一丨丨一
戽	户冫一丨丨丨	户冫一丨丨丨
绁	纟甘ㄋㄋㄋㄋ	纟甘ㄋㄋㄋㄋ
铗	金夹丿丶丶丶	金夹丿丶丶丶
卺	了水一丶丶丶	了水一丶丶丶
骟	马户ㄋ丶一ㄋ	马户ㄋ丶一ㄋ
滹	氵虍丿丶丿一	氵虍丿丶丿一
泚	氵此丨一丨一	氵此丨一丨一
醌	西日一ㄋ丿ㄋ	西日一ㄋ丿ㄋ
愔	忄音丶一丶丿	忄音丶一丶丿
浬	氵田丨ㄋ一一	氵田丨ㄋ一一
麹	丰文丿ㄋ丶丿	丰文丿ㄋ丶丿
躔	广丨ㄋ一一	广丨ㄋ一一
躞	火丶一一一	火丶一一一
躐	川丨ㄋ一ㄋ	川丨ㄋ一ㄋ
瘰	疒田ㄋㄋ丶丨	疒田ㄋㄋ丶丨
蓂	萝日丶一丿丶	萝日丶一丿丶
鞬	革聿ㄋ丶丶丶	革聿ㄋ丶丶丶
彖	彑豕丿ㄋ丿丿	彑豕丿ㄋ丿丿
鹣	兼鸟丿ㄋ丶ㄋ	兼鸟丿ㄋ丶ㄋ
缵	纟先丿一丨一	纟先丿一丨一
槠	木讠一丨一丿	木讠一丨一丿
皲	冖车ㄋ丿丨ㄋ	冖车ㄋ丿丨ㄋ
澌	氵其丿丿一丨	氵其丿丿一丨
漭	氵艹一丿丶丶	氵艹一丿丶丶
洎	氵自丿丨ㄋ一	氵自丿丨ㄋ一
豨	豕乂丨ㄋ丨丨	豕乂丨ㄋ丨丨
囝	口子ㄋ丨一一	口子ㄋ丨一一
刬	戋刂丨丨丨丨	戋刂丨丨丨丨
嚭	壴口一丿丨丶	壴口一丿丨丶
堃	方方一丨一一	方方一丨一一
籀	扌丿ㄋ丶ㄋ	扌丿ㄋ丶ㄋ
籥	合丨ㄋ一丨	合丨ㄋ一丨
郇	勹隹ㄋ丨丨丨	勹隹ㄋ丨丨丨
坌	分土一丨一一	分土一丨一一
詟	龙讠丶一一一	龙讠丶一一一
阇	门者一丨一丿	门者一丨一丿
枧	木见丨ㄋ丿ㄋ	木见丨ㄋ丿ㄋ
晡	日甫一丨ㄋ一	日甫一丨ㄋ一
崦	山大丨ㄋ一一	山大丨ㄋ一一
裒	亠鼠丿ㄋ丿丶	亠鼠丿ㄋ丿丶
襻	衤木丿丶丿丶	衤木丿丶丿丶
埗	土止丨丿丿丿	土止丨丿丿丿
飐	几乂丨一丨ㄋ	几乂丨一丨ㄋ
瞢	萝目丨ㄋ一一	萝目丨ㄋ一一
茌	荷土一丨一一	荷土一丨一一
蝓	虫亼丨ㄋ一一	虫亼丨ㄋ一一
靺	革笔一丨丿丶	革笔一丨丿丶
扆	户衣丶一丿ㄋ	户衣丶一丿ㄋ
嗞	口䒑ㄋㄋ丶ㄋ	口首ㄋㄋ丶ㄋ
挢	扌天丿丨丨丨	扌天丿丨丨丨
埴	土直一丨丨ㄋ	土直一丨丨ㄋ
蝥	矛文丨ㄋ一丨	矛文丨ㄋ一丨
脶	月口丨ㄋ丿丶	月口丨ㄋ丿丶
悰	忄宀一一丨丿	忄宀一一丨丿
冇	石冂丨ㄋㄋㄋ	石冂丨ㄋㄋㄋ
跬	圭一丨一一	圭一丨一一
蝰	虫大一丨一一	虫大一丨一一
儇	亻鬲丿ㄋ丿丶	亻鬲丿ㄋ丿丶
梃	木王ㄋ丶丶丶	木王ㄋ丶丶丶
旰	日舌一一丨丨	日舌一一丨丨
忮	忄十ㄋ丶丶丶	忄十ㄋ丶丶丶
埏	土笔丨一丨一	土笔丨一丨一
埸	土日丿ㄋ丿丿	土日丿ㄋ丿丿
谳	讠十丨ㄋ丶丿	讠十丨ㄋ丶丿
酎	西寸一丨丶丶	西寸一丨丶丶
舣	舟义丶丿丶丶	舟义丶丿丶丶
尪	尢王一一丨一	尢王一一丨一
崁	山土丿ㄋ丿丶	山土丿ㄋ丿丶
擿	扌立丨ㄋ丿丶	扌立丨ㄋ丿丶
牤	牛亡丶一ㄋㄋ	牛亡丶一ㄋㄋ
赆	贝尺丶丶丶丶	贝尺丶丶丶丶
癃	疒耳丿ㄋ丶丿	疒耳丿ㄋ丶丿
髹	长亻一丨丿丶	长亻一丨丿丶
钽	金旦丨ㄋ一一	金旦丨ㄋ一一
泖	氵留丿ㄋ丿ㄋ	氵留丿ㄋ丿ㄋ
豳	山豕一丿ㄋ丿	山豕一丿ㄋ丿
祼	衤日一丨丿丶	衤日一丨丿丶
罽	四广丶丿丿丶	四广丶丿丿丶
畎	田犬一丿丶丶	田犬一丿丶丶
酞	西大丶丶丶丶	西大丶丶丶丶
舡	舟工一丨一一	舟工一丨一一
舳	舟甲丨ㄋ一丨	舟甲丨ㄋ一丨
崟	山金丿丶一一	山金丿丶一一
抃	扌笔一丨丶丶	扌笔一丨丶丶
簏	鹿丶一丿ㄋ	鹿丶一丿ㄋ
亍	于一一丨丨丨	于一一丨丨丨
邠	分耳ㄋ丨丨丨	分耳ㄋ丨丨丨
丌	兀一丿丨丨丨	兀一丿丨丨丨
缊	纟日丨ㄋ丨丨	纟日丨ㄋ丨丨
哕	口山丿ㄋ丶丶	口山丿ㄋ丶丶
糸	糸ㄋㄋ丶丨丿	糸ㄋㄋ丶丨丿
曈	日立丨ㄋ一一	日立丨ㄋ一一
洇	氵因丨ㄋ一丿	氵因丨ㄋ一丿
罨	四大丨ㄋ一一	四大丨ㄋ一一
邽	圭耳ㄋ丨丨丨	圭耳ㄋ丨丨丨
鞳	革艹丿丶一丨	革艹丿丶一丨
亹	亠冂一丨ㄋ一	亠冂一丨ㄋ一
嵚	山金丿ㄋ丿丶	山金丿ㄋ丿丶
涴	氵宀丿ㄋ丶ㄋ	氵宀丿ㄋ丶ㄋ
沢	氵尺ㄋ一丿丶	氵尺ㄋ一丿丶
璺	鼠冂一丨ㄋ一	鼠冂一丨ㄋ一
筚	比一丨丨丨	比一丨丨丨
鞮	革是丨ㄋ一一	革是丨ㄋ一一
缌	纟田丶ㄋ丶丶	纟田丶ㄋ丶丶
绋	纟弓丿丨丨丨	纟弓丿丨丨丨
幞	巾业丶丿一一	巾业丶丿一一
耧	未米ㄋ丿一一	未米ㄋ丿一一
驵	马目丨ㄋ一一	马目丨ㄋ一一
栝	木舌丿一丨丨	木舌丿一丨丨
枘	木内丨ㄋ丿丶	木内丨ㄋ丿丶
旸	日㇉丿丿丿丿	日Z丿丿丿丿
岜	山巴ㄋ丨一ㄋ	山巴ㄋ丨一ㄋ
鲥	鱼日一丨丶丶	鱼日一丨丶丶
洿	氵大一一ㄋㄋ	氵大一一ㄋㄋ
溦	氵山一丿ㄋ丿	氵山一丿ㄋ丿
擐	扌四一丨ㄋ一	扌四一丨ㄋ一
疔	疒于一丨丨丨	疒于一丨丨丨
瘆	疒厶丿丿丿丿	疒厶丿丿丿丿
蔟	艹族丿一一丿	艹族丿一一丿
蓠	艹㐫丨ㄋㄋ丶	艹离丨ㄋㄋ丶
椠	车丘一丨丿丶	车丘一丨丿丶
轹	车留丨丿丶丶	车留丨丿丶丶
豇	豆工一丨一一	豆工一丨一一
锞	金日一丨丿丶	金日一丨丿丶
唣	口白一ㄋㄋㄋ	口白一ㄋㄋㄋ
檑	木丨ㄋ一丨	木丨ㄋ一丨
贳	甘乙丨ㄋ丿丶	甘乙丨ㄋ丿丶
泐	氵耳ㄋ丿丿丿	氵耳ㄋ丿丿丿
祎	衤韦一一ㄋ丨	衤韦一一ㄋ丨
祲	衤尹丶ㄋㄋ丶	衤尹丶ㄋㄋ丶
霅	讠丶一一一	讠丶一一一
亸	子丶丿丨ㄋ	子丶丿丨ㄋ
卬	留卩ㄋ丨丨丨	留卩ㄋ丨丨丨
垚	土土一丨一一	土土一丨一一
楯	木广一丨丨ㄋ	木广一丨丨ㄋ
欸	厶矢丿ㄋ丿丶	厶矢丿ㄋ丿丶
沚	氵止丨一丨一	氵止丨一丨一
潾	氵米丿ㄋ丶一	氵米丿ㄋ丶一
璘	王米丿ㄋ丶一	王米丿ㄋ丶一
觏	共冂一丨一丨	共冂一丨一丨
篚	匚丨一一一	匚丨一一一
蹁	户丨ㄋ一丨	户丨ㄋ一丨
疬	疒广ㄋ丿丿丿	疒广ㄋ丿丿丿
瘳	疒羽丿丶丿丿	疒羽丿丶丿丿
菉	艹尹丨ㄋ丿丶	艹尹丨ㄋ丿丶
缳	纟鬲丿ㄋ丿丶	纟鬲丿ㄋ丿丶
唛	口丰丿ㄋ丶丶	口丰丿ㄋ丶丶
耜	未吅丨ㄋ一ㄋ	未吅丨ㄋ一ㄋ
枨	木长丿一ㄋ丶	木长丿一ㄋ丶
眊	目毛丿一一ㄋ	目毛丿一一ㄋ
禋	衤西一丨一一	衤西一丨一一
攮	扌丨ㄋ一丨	扌丨ㄋ一丨
袪	衤去一丨一ㄋ	衤去一丨一ㄋ
襕	衤门一丨ㄋ一	衤门一丨ㄋ一
俶	亻上丨丿丶ㄋ	亻上丨丿丶ㄋ
倕	亻垂丿一丨一	亻垂丿一丨一
夐	鱼黑丨ㄋ一一	鱼黑丨ㄋ一一
惛	忄氏丨ㄋ一一	忄氏丨ㄋ一一
曌	日月丶丶ㄋ丿	日月丶丶ㄋ丿
黉	共丨ㄋ一丨	共丨ㄋ一丨
赙	贝甫一丨丶丶	贝甫一丨丶丶
瘐	疒鼠丿丶丶丶	疒鼠丿丶丶丶
苈	艹广ㄋ丿丿丿	艹广ㄋ丿丿丿
萆	艹卑丿丨ㄋ一	艹卑丿丨ㄋ一
蜱	虫卑丿丨ㄋ一	虫卑丿丨ㄋ一
桫	木氵丨丿丶丿	木氵丨丿丶丿
潲	氵禾丨丶丿丨	氵禾丨丶丿丨
洫	氵笔丨ㄋ丨丨	氵笔丨ㄋ丨丨
沩	氵笔ㄋ丿丶丶	氵笔ㄋ丿丶丶
嶒	山曾丶丿丨ㄋ	山曾丶丿丨ㄋ
惝	忄丨ㄋ丨ㄋ	忄丨ㄋ丨ㄋ
埤	土卑丿丨ㄋ一	土卑丿丨ㄋ一
珺	王尹丨ㄋ一一	王尹丨ㄋ一一
酺	西甫一丨ㄋ一	西甫一丨ㄋ一
翚	羽冖一ㄋ一丨	羽冖一ㄋ一丨
艨	舟萝一一丿ㄋ	舟萝一一丿ㄋ
瓘	王艹丨ㄋ一丨	王艹丨ㄋ一丨
皦	白白丶一ㄋ丿	白白丶一ㄋ丿
乂	乂丿丶丶丶丶	乂丿丶丶丶丶
羝	羊氏丶丶丶丶	羊氏丶丶丶丶
趵	勹丶丶丶丶	勹丶丶丶丶
蹐	水丿丶丨ㄋ	水丿丶丨ㄋ
跱	土一丨丶丶	土一丨丶丶
瘵	疒一一丨丿	疒祭一一丨丿
瘼	疒莫一丨丨丨	疒莫一丨丨丨
菪	艹宀一丿丨ㄋ	艹宀一丿丨ㄋ
蕞	艹日一丨丨一	艹日一丨丨一
辀	车舟丿丿ㄋ丶	车舟丿丿ㄋ丶
仉	亻几丿ㄋㄋㄋ	亻几丿ㄋㄋㄋ
僇	亻羽丿丶丿丿	亻羽丿丶丿丿
狳	犬亼一丨丿丶	犬亼一丨丿丶
犰	犬九丿ㄋㄋㄋ	犬九丿ㄋㄋㄋ
鞨	革日丿ㄋ丿丶	革日丿ㄋ丿丶
黟	黑歹丿ㄋ丶丶	黑歹丿ㄋ丶丶
綮	户文ㄋㄋ丶丨	户文ㄋㄋ丶丨
镦	金ㄋ丨一丿	金ㄋ丨一丿
鼯	鼠五丨ㄋ一一	鼠五丨ㄋ一一
鸰	令鸟丿ㄋ丶ㄋ	令鸟丿ㄋ丶ㄋ
骍	马辛丶一丶丿	马辛丶一丶丿
鹍	日比丿ㄋ丶ㄋ	日比丿ㄋ丶ㄋ
磡	石其ㄋㄋ丿丿	石其ㄋㄋ丿丿
忭	忄笔一丨丶丶	忄笔一丨丶丶
忉	忄刀ㄋ丿丿丿	忄刀ㄋ丿丿丿
怃	忄笔一丿ㄋㄋ	忄笔一丿ㄋㄋ
擗	扌辟ㄋ一丿丨	扌辟ㄋ一丿丨
掎	扌大一丨ㄋ一	扌大一丨ㄋ一
诐	讠皮ㄋ丿丨ㄋ	讠皮ㄋ丿丨ㄋ
鲻	鱼川丨ㄋ一丨	鱼川丨ㄋ一丨
鲹	鱼厶丿丿丿丿	鱼厶丿丿丿丿
龁	止ㄋㄋㄋㄋ	止ㄋㄋㄋㄋ
盦	令西丨ㄋ丨丨	令西丨ㄋ丨丨
咍	口厶丨ㄋ一一	口厶丨ㄋ一一
壸	亚一丨丨丶	亚一丨丨丶
沄	氵云一一ㄋ丶	氵云一一ㄋ丶
皞	白白一丿丶一	白白一丿丶一
赑	贝贝丨ㄋ丿丶	贝贝丨ㄋ丿丶
芴	艹勿丿ㄋ丿丿	艹勿丿ㄋ丿丿
蒽	艹因丶ㄋ丶丶	艹因丶ㄋ丶丶
蜞	虫其一丨丨一	虫其一丨丨一
夼	大川丿丨丨丨	大川丿丨丨丨
仳	亻比一ㄋ丿ㄋ	亻比一ㄋ丿ㄋ
狃	犬丑ㄋ丨一一	犬丑ㄋ丨一一
庳	广卑丿丨ㄋ一	广卑丿丨ㄋ一
魋	鬼隹丿丨丶一	鬼隹丿丨丶一
帱	巾丰一丨丶丶	巾丰一丨丶丶
镘	金日丨ㄋ丨丨	金日丨ㄋ丨丨
噍	口隹丶丶丶丶	口隹丶丶丶丶
呙	口内丨ㄋ丿丶	口内丨ㄋ丿丶
瀹	氵亼丨ㄋ一丨	氵亼丨ㄋ一丨
屺	山巴ㄋ一ㄋㄋ	山巴ㄋ一ㄋㄋ
碲	石立丨ㄋ丨丨	石立丨ㄋ丨丨
掊	扌立丨ㄋ一一	扌立丨ㄋ一一
垤	土至一ㄋ丶一	土至一ㄋ丶一
窊	穴爪丿丿ㄋ丶	穴爪丿丿ㄋ丶
谫	讠前ㄋ丿丿丿	讠前ㄋ丿丿丿
襜	衤厃丿丶丶一	衤厃丿丶丶一
酾	西丽一丨ㄋ丶	西丽一丨ㄋ丶
霪	氵丿丶丶丿	氵丿丶丶丿
鄠	二ㄋㄋ丨丨	二ㄋㄋ丨丨
吽	口牛丿一一丨	口牛丿一一丨
恓	忄西一丨ㄋ丿	忄西一丨ㄋ丿
浐	氵立一丿丿丿	氵立一丿丿丿
滉	氵日丨丶丿一	氵日丨丶丿一
琇	王禾ㄋ丿丿丿	王禾ㄋ丿丿丿
箅	田丨ㄋ一丨	田丨ㄋ一丨
趼	开一一丿丨	开一一丿丨
蹅	木丨ㄋ一一	木丨ㄋ一一
蒗	落笔ㄋ一一ㄋ	落笔ㄋ一一ㄋ
苘	艹冂丨ㄋ一一	艹冂丨ㄋ一一
薷	艹一丿丨ㄋ	艹一丿丨ㄋ
蚵	虫于丨ㄋ一一	虫于丨ㄋ一一
傒	亻爪ㄋㄋ丶一	亻爪ㄋㄋ丶一
顸	舌页一丿丨ㄋ	舌页一丿丨ㄋ
稃	禾爪ㄋ丨一一	禾爪ㄋ丨一一
焜	火日一ㄋ丿ㄋ	火日一ㄋ丿ㄋ
缋	纟丨ㄋ丿丶	纟丨ㄋ丿丶
绗	纟彳一一丨丨	纟彳一一丨丨
镟	金族丨一丿丶	金族丨一丿丶
哜	口文丿丨丨丨	口文丿丨丨丨
阘	门日ㄋ丶一ㄋ	门日ㄋ丶一ㄋ
楗	木聿ㄋ丶丶丶	木聿ㄋ丶丶丶
氽	人水丨ㄋ丿丶	人水丨ㄋ丿丶
浍	氵人一一ㄋ丶	氵人一一ㄋ丶
滏	氵父一一丨丶	氵父一一丨丶
崚	山土丿丶丿ㄋ	山土丿丶丿ㄋ
撙	扌酋一丨丶丶	扌酋一丨丶丶
摛	扌㐫丨ㄋㄋ丶	扌离丨ㄋㄋ丶
颃	亠几一丿丨ㄋ	亠几一丿丨ㄋ
酴	西亼一丨丿丶	西亼一丨丿丶
貘	豸莫一丨丨丨	豸莫一丨丨丨
舯	舟中丨ㄋ一丨	舟中丨ㄋ一丨
馘	䒑自一ㄋ丿丶	首自一ㄋ丿丶
镵	金象一ㄋ丿ㄋ	金象一ㄋ丿ㄋ
唵	口大丨ㄋ一一	口大丨ㄋ一一
抔	扌不一丿丨丶	扌不一丿丨丶
斝	吅冖丶丶一丨	吅冖丶丶一丨
梼	木丰一丨丶丶	木丰一丨丶丶
齁	自田丿ㄋ丨ㄋ	自田丿ㄋ丨ㄋ
弇	合开一丿丨丨	合开一丿丨丨
瘥	疒羊一丨一一	疒羊一丨一一
瘕	疒叚ㄋ一丨一	疒叚ㄋ一丨一
觫	角束一丨ㄋ一	角束一丨ㄋ一
镮	金鬲丿ㄋ丿丶	金鬲丿ㄋ丿丶
冱	冫笔ㄋㄋ一一	冫笔ㄋㄋ一一
鹇	门木丿ㄋ丶ㄋ	门木丿ㄋ丶ㄋ
糍	米䒑ㄋㄋ丶ㄋ	米首ㄋㄋ丶ㄋ
檫	木宀丿ㄋ丶丶	木宀丿ㄋ丶丶
矻	石ㄋㄋㄋㄋ	石ㄋㄋㄋㄋ
尢	尢一丿ㄋㄋㄋ	尢一丿ㄋㄋㄋ
鲯	鱼其一丨丨一	鱼其一丨丨一
鳣	鱼亠丨ㄋ丨ㄋ	鱼亠丨ㄋ丨ㄋ
趑	走次丶一丿ㄋ	走次丶一丿ㄋ
厖	广尢丿丿丿丶	广尢丿丿丿丶
姱	女大一一ㄋㄋ	女大一一ㄋㄋ
忺	忄欠丿ㄋ丿丶	忄欠丿ㄋ丿丶
晢	折日丨ㄋ一一	折日丨ㄋ一一
渰	氵合一丿丨丨	氵合一丿丨丨
烜	火笔丨ㄋ一一	火笔丨ㄋ一一
飔	几乂丨ㄋ一丨	几乂丨ㄋ一丨
裛	亠口ㄋ丨一ㄋ	亠口ㄋ丨一ㄋ
龠	亼吅丨ㄋ一丨	亼吅丨ㄋ一丨
筅	先丿一丨一	先丿一丨一
箦	丰丨ㄋ丿丶	丰丨ㄋ丿丶
茇	艹石ㄋ丶丶丶	艹石ㄋ丶丶丶
颟	艹丙丿丶丿丶	艹丙丿丶丿丶
蜾	虫日一丨丿丶	虫日一丨丿丶
佾	亻八丨ㄋ一一	亻八丨ㄋ一一
恧	而心丶ㄋ丶丶	而心丶ㄋ丶丶
铪	金合丿丶一丨	金合丿丶一丨
虓	九虍丿ㄋㄋㄋ	九虍丿ㄋㄋㄋ
糌	米文丨丶丨ㄋ	米文丨丶丨ㄋ
眭	目圭一丨一一	目圭一丨一一
汆	入水丨ㄋ丿丶	入水丨ㄋ丿丶
漶	氵口丨ㄋ一一	氵口丨ㄋ一一
剀	山巴丨丨丨丨	山巴丨丨丨丨
嵎	山日丨ㄋ丨一	山日丨ㄋ丨一
饹	食各丿ㄋ丶丨	食各丿ㄋ丶丨
砟	石乍丿一丨一	石乍丿一丨一
揸	扌木丨ㄋ一一	扌木丨ㄋ一一
坜	土广ㄋ丿丿丿	土广ㄋ丿丿丿
鲿	鱼丶ㄋ一一	鱼丶ㄋ一一
腠	月丿一丿丶	月丿一丿丶
婞	女土丶丿一一	女土丶丿一一
昇	日笔一丿丨丨	日笔一丿丨丨
枲	厶口一丨丿丶	厶口一丨丿丶
椓	木豕丶丶丶丶	木豕丶丶丶丶
毐	土母ㄋㄋ丿一	土母ㄋㄋ丿一
甪	笔甬丿ㄋ一一	笔甬丿ㄋ一一
踦	大一丨ㄋ一	大一丨ㄋ一
赇	贝求一丨丶一	贝求一丨丶一
瘅	疒单丶丿丨ㄋ	疒单丶丿丨ㄋ
蒨	荷青一一丨一	荷青一一丨一
恝	丰刀丶ㄋ丶丶	丰刀丶ㄋ丶丶
魆	鬼戊一ㄋㄋ丿	鬼戊一ㄋㄋ丿
烀	火乎丿丶丿一	火乎丿丶丿一
孓	了笔丶丶丶丶	了笔丶丶丶丶
牾	牛五丨ㄋ一一	牛五丨ㄋ一一
刭	轻刂丨丨丨丨	轻刂丨丨丨丨
潏	氵矛丨ㄋ丿丶	氵矛丨ㄋ丿丶
瀼	氵亠丨ㄋ一丨	氵亠丨ㄋ一丨
硙	石山ㄋ一ㄋㄋ	石山ㄋ一ㄋㄋ
圬	土二ㄋㄋㄋㄋ	土二ㄋㄋㄋㄋ
璠	王釆丨ㄋ一丨	王釆丨ㄋ一丨
嚚	吅臣丨ㄋ一丨	吅臣丨ㄋ一丨
裈	衤冖一ㄋ一丨	衤冖一ㄋ一丨
劓	自田丨丨丨丨	自田丨丨丨丨
逴	卜日一丨丶ㄋ	卜日一丨丶ㄋ
冏	冂八丨ㄋ一一	冂八丨ㄋ一一
渟	氵一丨丨丨	氵一丨丨丨
畬	亼木丨ㄋ一丨	亼木丨ㄋ一丨
郤	八人丨ㄋ一ㄋ	八人丨ㄋ一ㄋ
菝	艹扌一丿丿丿	艹扌一丿丿丿
廒	广敖一一丨一	广敖一一丨一
鹖	日勹丿丶ㄋ丿	日勹丿丶ㄋ丿
戋	戋一一ㄋ丿丶	戋一一ㄋ丿丶
缲	纟口丨ㄋ一丨	纟口丨ㄋ一丨
锔	金尸ㄋ丨ㄋ一	金尸ㄋ丨ㄋ一
铈	金亠丨ㄋ丨丨	金亠丨ㄋ丨丨
骒	马日一丨丿丶	马日一丨丿丶
柃	木令丿丶丶ㄋ	木令丿丶丶ㄋ
眵	目歹丿ㄋ丶丶	目歹丿ㄋ丶丶
洧	氵石丨ㄋ一一	氵石丨ㄋ一一
碶	石丰ㄋ丿一丿	石丰ㄋ丿一丿
矧	矢弓丨丨丨丨	矢弓丨丨丨丨
榖	笔一丨丿丶	笔一丨丿丶
禘	衤立丨ㄋ丨丨	衤立丨ㄋ丨丨
揲	扌甘ㄋ一丨丿	扌甘ㄋ一丨丿
拃	扌乍丿一丨一	扌乍丿一丨一
墁	土日丨ㄋ丨丨	土日丨ㄋ丨丨
璁	王丿ㄋ丶一	王丿ㄋ丶一
鲦	鱼文一丨丿丶	鱼文一丨丿丶
鳀	鱼是丨ㄋ一一	鱼是丨ㄋ一一
鲬	鱼甬ㄋ丶丨ㄋ	鱼甬ㄋ丶丨ㄋ
舲	舟令丿丶丶ㄋ	舟令丿丶丶ㄋ
隩	耳丶丿一丨	耳丶丿一丨
昉	日方丶一ㄋ丿	日方丶一ㄋ丿
柈	木半丶丿一一	木半丶丿一一
椀	木宀丿ㄋ丶ㄋ	木宀丿ㄋ丶ㄋ
牂	片羊丶丿一一	片羊丶丿一一
郿	尸目ㄋ丨丨丨	尸目ㄋ丨丨丨
勍	京力ㄋ丿丿丿	京力ㄋ丿丿丿
坰	土冂丨ㄋ一一	土冂丨ㄋ一一
酂	先先丨ㄋ丿丶	先先丨ㄋ丿丶
跽	巴丶ㄋ丶丶	巴丶ㄋ丶丶
痖	疒亚一丨丨丶	疒亚一丨丨丶
癀	疒共丨ㄋ一丨	疒共丨ㄋ一丨
茈	艹此丨一丨一	艹此丨一丨一
蔸	艹白丿丨ㄋ一	艹白丿丨ㄋ一
蝤	虫酋丶丿一丨	虫酋丶丿一丨
殪	歹一丨ㄋ一	歹一丨ㄋ一
觋	工从丨ㄋ丿ㄋ	工从丨ㄋ丿ㄋ
骺	骨广一丨ㄋ一	骨广一丨ㄋ一
缞	纟一丿ㄋ丿	纟一丿ㄋ丿
绹	纟勹丿一一丨	纟勹丿一一丨
钐	金川丿丿丿丿	金川丿丿丿丿
铫	金儿丶一丿丶	金儿丶一丿丶
锳	金艹丨ㄋ一丿	金艹丨ㄋ一丿
唼	口立ㄋ丿一一	口立ㄋ丿一一
啫	口者一丨一丿	口者一丨一丿
驲	马日丨ㄋ一一	马日丨ㄋ一一
糈	米走丨ㄋ一一	米走丨ㄋ一一
檎	木人丶一丿丶	木人丶一丿丶
桕	木鼠丿丨一ㄋ	木鼠丿丨一ㄋ
嫪	女羽丿丶丿丿	女羽丿丶丿丿
郐	人云ㄋ丨丨丨	人云ㄋ丨丨丨
汔	氵ㄋㄋㄋㄋ	氵ㄋㄋㄋㄋ
滃	氵公ㄋ丶一ㄋ	氵公ㄋ丶一ㄋ
岽	山车丨丿丶丶	山车丨丿丶丶
饸	食合丿丶一丨	食合丿丶一丨
礅	石ㄋ丨一丿	石ㄋ丨一丿
翾	四鬲丿ㄋ丿丶	四鬲丿ㄋ丿丶
揠	扌匚丨ㄋ一一	扌匚丨ㄋ一一
坫	土占丨一丨ㄋ	土占丨一丨ㄋ
塄	土四丶一ㄋ丿	土四丶一ㄋ丿
玦	王匚丿丶丶丶	王匚丿丶丶丶
觱	戊鬲丿ㄋ丿ㄋ	戊鬲丿ㄋ丿ㄋ
诇	讠冂丨ㄋ一一	讠冂丨ㄋ一一
鲼	鱼十一丨丨丨	鱼十一丨丨丨
毹	亼月丨丨丿一	亼月丨丨丿一
臑	月一丿丨ㄋ	月一丿丨ㄋ
縢	月ㄋㄋ丶丨	月ㄋㄋ丶丨
艋	舟子丨ㄋ丨丨	舟子丨ㄋ丨丨
陴	耳卑丿丨ㄋ一	耳卑丿丨ㄋ一
劄	合丨丨丨丨	合丨丨丨丨
尨	尢川丶丶丶丶	尢川丶丶丶丶
岨	山目丨ㄋ一一	山目丨ㄋ一一
崿	山吅一一ㄋㄋ	山吅一一ㄋㄋ
巉	山象一ㄋ丿ㄋ	山象一ㄋ丿ㄋ
帨	巾𠮦丿ㄋㄋㄋ	巾兑丿ㄋㄋㄋ
槚	木西丨ㄋ丿丶	木西丨ㄋ丿丶
氿	氵九丿ㄋㄋㄋ	氵九丿ㄋㄋㄋ
熛	火西一一丨丿	火西一一丨丿
枒	木牙一ㄋ丨丿	木牙一ㄋ丨丿
耑	山而一丿丨ㄋ	山而一丿丨ㄋ
醾	西麻丶丿一丨	西麻丶丿一丨
巇	山虍一丨ㄋ一	山虍一丨ㄋ一
鹡	水人丨ㄋ一一	水人丨ㄋ一一
埆	土角丿ㄋ丿ㄋ	土角丿ㄋ丿ㄋ
筦	宀一一丿ㄋ	宀一一丿ㄋ
簃	禾丿ㄋ丶丿	禾丿ㄋ丶丿
躜	先丿一丨一	先丿一丨一
蒻	艹弓丶一丶一	艹弓丶一丶一
轵	车口丿丶丶丶	车口丿丶丶丶
衎	彳舌一一丨丨	彳舌一一丨丨
螗	虫广ㄋ一一丨	虫广ㄋ一一丨
蛸	虫丨ㄋ一一	虫丨ㄋ一一
僬	亻隹丶丶丶丶	亻隹丶丶丶丶
俵	亻丰丿ㄋ丿丶	亻丰丿ㄋ丿丶
靸	革及丿ㄋ丶丶	革及丿ㄋ丶丶
熇	火丨ㄋ一一	火丨ㄋ一一
钖	金㇉丿丿丿丿	金Z丿丿丿丿
麑	鹿鼠丿ㄋㄋㄋ	鹿鼠丿ㄋㄋㄋ
訚	门讠丶一一一	门讠丶一一一
楙	木矛一丨丿丶	木矛一丨丿丶
氍	目目丿丨丶一	目目丿丨丶一
媞	女是丨ㄋ一一	女是丨ㄋ一一
鸧	人巴丿ㄋ丶ㄋ	人巴丿ㄋ丶ㄋ
渫	氵甘ㄋ一丨丿	氵甘ㄋ一丨丿
淠	氵田丨ㄋ一丨	氵田丨ㄋ一丨
嵫	山䒑ㄋㄋ丶ㄋ	山首ㄋㄋ丶ㄋ
崒	山亠丿丶丿丶	山亠丿丶丿丶
硁	石轻ㄋ丶一丨	石轻ㄋ丶一丨
谞	讠走丨ㄋ一一	讠走丨ㄋ一一
悝	忄田丨ㄋ一一	忄田丨ㄋ一一
埘	土日一丨丶丶	土日一丨丶丶
垧	土丨ㄋ一一	土丨ㄋ一一
瑨	王亚丨ㄋ一一	王亚丨ㄋ一一
鲐	鱼厶丨ㄋ一一	鱼厶丨ㄋ一一
脬	月爪ㄋ丨一一	月爪ㄋ丨一一
舴	舟乍丿一丨一	舟乍丿一丨一
哢	口王一丿丨丨	口王一丿丨丨
夬	匚人丿丶丶丶	匚人丿丶丶丶
峣	山尧一ㄋ丿一	山尧一ㄋ丿一
廋	广鼠丨ㄋ丶丶	广鼠丨ㄋ丶丶
惙	忄双ㄋ丶ㄋ丶	忄双ㄋ丶ㄋ丶
挦	扌尹一丨丶丶	扌尹一丨丶丶
杻	木丑ㄋ丨一一	木丑ㄋ丨一一
棐	非木一丨丿丶	非木一丨丿丶
欻	火火丿ㄋ丿丶	火火丿ㄋ丿丶
氾	氵巴ㄋㄋㄋㄋ	氵巴ㄋㄋㄋㄋ
浡	氵十丶ㄋㄋ丨	氵十丶ㄋㄋ丨
爇	艹土丿丶一丨	艹土丿丶一丨
皛	白白丿丨ㄋ一	白白丿丨ㄋ一
嬅	女艹一一丨丨	女艹一一丨丨
憝	子丿一丿丶	子丿一丿丶
翃	石厶ㄋ丶一ㄋ	石厶ㄋ丶一ㄋ
簕	革ㄋ丿丿丿	革ㄋ丿丿丿
癍	疒王丶一丿丶	疒王丶一丿丶
蒉	艹丨ㄋ丿丶	艹丨ㄋ丿丶
蔀	艹立丨ㄋ一ㄋ	艹立丨ㄋ一ㄋ
萩	艹禾丶丿丿丶	艹禾丶丿丿丶
荄	艹亥丶一ㄋ丿	艹亥丶一ㄋ丿
糵	艹笔丨ㄋ一ㄋ	艹笔丨ㄋ一ㄋ
鬘	长日丨ㄋ丨丨	长日丨ㄋ丨丨
蜎	虫口丨ㄋ一一	虫口丨ㄋ一一
髎	骨羽丿丶丿丿	骨羽丿丶丿丿
稂	禾笔ㄋ一一ㄋ	禾笔ㄋ一一ㄋ
穟	禾冫一丿ㄋ丿	禾冫一丿ㄋ丿
飑	几乂丿ㄋㄋ一	几乂丿ㄋㄋ一
镙	金田ㄋㄋ丶丨	金田ㄋㄋ丶丨
镡	金西丨ㄋ一一	金西丨ㄋ一一
钬	金火丶丿丿丶	金火丶丿丿丶
铼	金夹丨丿丶丶	金夹丨丿丶丶
鄜	鹿耳ㄋ丨丨丨	鹿耳ㄋ丨丨丨
橦	木立丨ㄋ一一	木立丨ㄋ一一
瞍	目鼠丨ㄋ丶丶	目鼠丨ㄋ丶丶
溱	氵一丨丿丶	氵一丨丿丶
沨	氵几丿丶丶丶	氵几丿丶丶丶
濩	氵艹丿丨丶一	氵艹丿丨丶一
屼	山笔丿ㄋㄋㄋ	山笔丿ㄋㄋㄋ
甏	壴川一ㄋㄋ丶	壴川一ㄋㄋ丶
捃	扌尹丨ㄋ一一	扌尹丨ㄋ一一
搒	扌立丶一ㄋ丿	扌立丶一ㄋ丿
垲	土山ㄋ一ㄋㄋ	土山ㄋ一ㄋㄋ
珧	王儿丶一丿丶	王儿丶一丿丶
黹	业米丶丿丨ㄋ	业米丶丿丨ㄋ
醨	西㐫丨ㄋㄋ丶	西离丨ㄋㄋ丶
脒	月米丶丿一丨	月米丶丿一丨
迮	乍辶丶ㄋ丶丶	乍辶丶ㄋ丶丶
馌	食去丨ㄋ丨丨	食去丨ㄋ丨丨
掞	扌火丶丿丿丶	扌火丶丿丿丶
昺	日丙丿丶丶丶	日丙丿丶丶丶
杙	木戋一ㄋ丶丶	木戋一ㄋ丶丶
棓	木立丨ㄋ一一	木立丨ㄋ一一
棨	户文一丨丿丶	户文一丨丿丶
洑	氵亻一丿丶丶	氵亻一丿丶丶
洸	氵光丨丶丿一	氵光丨丶丿一
淏	氵日一一丿丶	氵日一一丿丶
畯	田厶丿丶丿ㄋ	田厶丿丶丿ㄋ
飗	几乂丿ㄋ丶ㄋ	几乂丿ㄋ丶ㄋ
篥	西一丨丿丶	西一丨丿丶
簠	甫丨ㄋ丨丨	甫丨ㄋ丨丨
跐	此丨一丨一	此丨一丨一
鹋	艹田丿ㄋ丶ㄋ	艹田丿ㄋ丶ㄋ
蔹	艹亼丶丶丿一	艹亼丶丶丿一
莰	艹土丿ㄋ丿丶	艹土丿ㄋ丿丶
莛	艹王ㄋ丶丶丶	艹王ㄋ丶丶丶
荬	艹㇉丶丶一丿	艹Z丶丶一丿
蒐	艹鬼丿丨ㄋ一	艹鬼丿丨ㄋ一
芃	艹几丶丶丶丶	艹几丶丶丶丶
藟	艹田丨ㄋ一丨	艹田丨ㄋ一丨
髽	长从一丨一一	长从一丨一一
剞	大可丨丨丨丨	大可丨丨丨丨
奓	大歹丿ㄋ丶丶	大歹丿ㄋ丶丶
佧	亻上丨丶丶丶	亻上丨丶丶丶
伈	亻心丶ㄋ丶丶	亻心丶ㄋ丶丶
狁	犬厶丿ㄋㄋㄋ	犬厶丿ㄋㄋㄋ
靿	革幺ㄋ丿丿丿	革幺ㄋ丿丿丿
秬	禾匚ㄋ一一一	禾匚ㄋ一一一
黪	黑厶丿丿丿丿	黑厶丿丿丿丿
缍	纟垂丿一丨一	纟垂丿一丨一
锇	金我丿一丨一	金我丿一丨一
铏	金开一一丿丨	金开一一丿丨
锽	金白一一丨一	金白一一丨一
粿	米日一丨丿丶	米日一丨丿丶
睎	目乂丨ㄋ丨丨	目乂丨ㄋ丨丨
嫜	女音一丨丨丨	女音一丨丨丨
浈	氵卜丨ㄋ丿丶	氵卜丨ㄋ丿丶
滆	氵鬲一丨ㄋ一	氵鬲一丨ㄋ一
澥	氵角ㄋ丿丿一	氵角ㄋ丿丿一
碥	石户丨ㄋ一丨	石户丨ㄋ一丨
謦	土尸丿ㄋㄋ丶	土尸丿ㄋㄋ丶
芈	笔笔丨一一一	笔笔丨一一一
赟	文笔一ㄋ丶丨	文笔一ㄋ丶丨
眢	歹巴丨ㄋ一一	歹巴丨ㄋ一一
尜	小大丨丿丶丶	小大丨丿丶丶
襚	衤冫一丿ㄋ丿	衤冫一丿ㄋ丿
鳓	鱼革ㄋ丿丿丿	鱼革ㄋ丿丿丿
鲣	鱼一丨一一	鱼一丨一一
鳑	鱼立丶一ㄋ丿	鱼立丶一ㄋ丿
鲏	鱼皮ㄋ丿丨ㄋ	鱼皮ㄋ丿丨ㄋ
鲗	鱼贝丨丨丨丨	鱼贝丨丨丨丨
翀	羽中丨ㄋ一丨	羽中丨ㄋ一丨
脞	月从一丨一一	月从一丨一一
腧	月亼丨ㄋ一一	月亼丨ㄋ一一
阽	耳占丨一丨ㄋ	耳占丨一丨ㄋ
腯	月广一丨丨ㄋ	月广一丨丨ㄋ
镋	金丿ㄋㄋㄋ	金丿ㄋㄋㄋ
剟	双双丨丨丨丨	双双丨丨丨丨
墐	土堇一丨丨一	土堇一丨丨一
弢	弓山ㄋ丶丶丶	弓山ㄋ丶丶丶
暵	日甘丨ㄋ一丿	日甘丨ㄋ一丿
枹	木勹ㄋ一ㄋㄋ	木勹ㄋ一ㄋㄋ
溞	氵双丶丨ㄋ一	氵双丶丨ㄋ一
滪	氵矛一丿丨ㄋ	氵矛一丿丨ㄋ
潟	氵鼠丿ㄋ丶丶	氵鼠丿ㄋ丶丶
烺	火笔ㄋ一一ㄋ	火笔ㄋ一一ㄋ
瑑	王彑丿ㄋ丿丿	王彑丿ㄋ丿丿
瑳	王羊一丨一一	王羊一丨一一
踶	是丨ㄋ一一	是丨ㄋ一一
赒	贝冂一丨一丨	贝冂一丨一丨
赗	贝日丨ㄋ一一	贝日丨ㄋ一一
瘃	疒豕丶丶丶丶	疒豕丶丶丶丶
茚	艹留一ㄋ丨丨	艹留一ㄋ丨丨
蒎	落广丿ㄋ丿丶	落广丿ㄋ丿丶
蕰	落日丨ㄋ丨丨	落日丨ㄋ丨丨
辌	车京丶一丨ㄋ	车京丶一丨ㄋ
墼	车冂丿ㄋㄋ丶	车冂丿ㄋㄋ丶
蝻	虫十丨ㄋ丶丿	虫十丨ㄋ丶丿
蠋	虫四丿ㄋ丨ㄋ	虫四丿ㄋ丨ㄋ
聍	耳宀一丨丨丨	耳宀一丨丨丨
耵	耳于一丨丨丨	耳于一丨丨丨
猰	犬丰ㄋ丿一丿	犬丰ㄋ丿一丿
鞡	革扌丶一丶丿	革扌丶一丶丿
瓞	爪笔一一丿丶	爪笔一一丿丶
廑	广堇一丨丨一	广堇一丨丨一
爝	火爪丨ㄋ丨丨	火爪丨ㄋ丨丨
爚	火合丨ㄋ一丨	火合丨ㄋ一丨
铷	金女丨ㄋ一一	金女丨ㄋ一一
锾	金爪一一丿ㄋ	金爪一一丿ㄋ
镴	金川丨ㄋ一ㄋ	金川丨ㄋ一ㄋ
镈	金甫一丨丶丶	金甫一丨丶丶
鼷	鼠爪ㄋㄋ丶一	鼠爪ㄋㄋ丶一
粞	米西一丨ㄋ丿	米西一丨ㄋ丿
椐	木尸一丨丨ㄋ	木尸一丨丨ㄋ
橑	木大丶丶丨ㄋ	木大丶丶丨ㄋ
鹔	聿八丿丨丿ㄋ	聿八丿丨丿ㄋ
嫽	女大丶丶丨ㄋ	女大丶丶丨ㄋ
碹	石宀一丨ㄋ一	石宀一丨ㄋ一
礌	石丨ㄋ一丨	石丨ㄋ一丨
怊	忄刀丨ㄋ一一	忄刀丨ㄋ一一
忳	忄屯一ㄋ丨ㄋ	忄屯一ㄋ丨ㄋ
憺	忄厃丿丶丶一	忄厃丿丶丶一
琭	王尹丨ㄋ丿丶	王尹丨ㄋ丿丶
瑢	王穴丿丶丨ㄋ	王穴丿丶丨ㄋ
璆	王羽丿丶丿丿	王羽丿丶丿丿
圊	口青一一丨一	口青一一丨一
袆	衤韦一一ㄋ丨	衤韦一一ㄋ丨
褕	衤亼丨ㄋ一一	衤亼丨ㄋ一一
鹴	相丿ㄋ丶ㄋ	相丿ㄋ丶ㄋ
螣	月丨ㄋ一丨	月丨ㄋ一丨
肸	月八一丨丨丨	月八一丨丨丨
谿	爪幺一丿丶丿	爪幺一丿丶丿
龂	止丘ㄋ丨丿丿	止丘ㄋ丨丿丿
舠	舟刀ㄋ丿丿丿	舟刀ㄋ丿丿丿
蒱	艹扌一丨ㄋ一	艹扌一丨ㄋ一
偲	亻田丶ㄋ丶丶	亻田丶ㄋ丶丶
儳	亻象一ㄋ丿ㄋ	亻象一ㄋ丿ㄋ
叆	云一丿ㄋ丶	云一丿ㄋ丶
孅	女从一ㄋ丿丶	女从一ㄋ丿丶
惔	忄火丶丿丿丶	忄火丶丿丿丶
朳	木八丿丶丶丶	木八丿丶丶丶
烔	火冂一丨ㄋ一	火冂一丨ㄋ一
狝	犬尔丿ㄋ丨丿	犬尔丿ㄋ丨丿
琤	王争丿ㄋㄋ一	王争丿ㄋㄋ一
琯	王宀丨ㄋ一ㄋ	王宀丨ㄋ一ㄋ
疢	疒火丶丿丿丶	疒火丶丿丿丶
彳	彳丿丿丨丨丨	彳丿丿丨丨丨
澴	氵四一丨ㄋ一	氵四一丨ㄋ一
埼	土大一丨ㄋ一	土大一丨ㄋ一
墦	土釆丨ㄋ一丨	土釆丨ㄋ一丨
篼	白丿ㄋ丿ㄋ	白丿ㄋ丿ㄋ
簰	片丿丨ㄋ一	片丿丨ㄋ一
筥	口丨ㄋ一一	口丨ㄋ一一
羕	羊笔ㄋㄋ丿丶	羊笔ㄋㄋ丿丶
鲞	鱼丿ㄋ丨ㄋ	鱼丿ㄋ丨ㄋ
蹯	釆丨ㄋ一丨	釆丨ㄋ一丨
冁	单尸一丨丨一	单尸一丨丨一
雊	勹口丿丨丶一	勹口丿丨丶一
蕺	艹口一丨丨一	艹口一丨丨一
茺	艹亡丿ㄋㄋㄋ	艹亡丿ㄋㄋㄋ
莶	艹亼丶丶丿一	艹亼丶丶丿一
茝	艹臣一丨丨ㄋ	艹臣一丨丨ㄋ
鬏	长禾丶丿丿丶	长禾丶丿丿丶
劂	广屰丿ㄋ丿丶	广屰丿ㄋ丿丶
黡	广犬丨ㄋ丶丿	广犬丨ㄋ丶丿
辁	车人一一丨一	车人一一丨一
螋	虫鼠丨ㄋ丶丶	虫鼠丨ㄋ丶丶
仂	亻力ㄋ丿丿丿	亻力ㄋ丿丿丿
伋	亻及丿ㄋ丶丶	亻及丿ㄋ丶丶
稆	禾口丨ㄋ一一	禾口丨ㄋ一一
纴	纟王丿一丨一	纟王丿一丨一
觖	角匚丿丶丶丶	角匚丿丶丶丶
觿	角山丿丨丶一	角山丿丨丶一
铘	金牙ㄋ丨丨丨	金牙ㄋ丨丨丨
铟	金因丨ㄋ一丿	金因丨ㄋ一丿
锓	金尹丶ㄋㄋ丶	金尹丶ㄋㄋ丶
镠	金羽丿丶丿丿	金羽丿丶丿丿
唪	口一一丨丨	口一一丨丨
耇	者勹丨ㄋ一一	者勹丨ㄋ一一
杩	木马ㄋㄋ一一	木马ㄋㄋ一一
胬	奴内丿丶丶丶	奴内丿丶丶丶
昽	日龙一丿ㄋ丿	日龙一丿ㄋ丿
滠	氵耳ㄋ丶ㄋ丶	氵耳ㄋ丶ㄋ丶
瀵	氵米丨ㄋ一丨	氵米丨ㄋ一丨
岠	山匚ㄋ一一一	山匚ㄋ一一一
疐	田ㄋ丨一丿	田ㄋ丨一丿
矰	矢曾丶丿丨ㄋ	矢曾丶丿丨ㄋ
祃	衤马ㄋㄋ一一	衤马ㄋㄋ一一
韨	韦石ㄋ丶丶丶	韦石ㄋ丶丶丶
彟	尹寸一丨丨ㄋ	尹寸一丨丨ㄋ
酏	西也ㄋ丨ㄋㄋ	西也ㄋ丨ㄋㄋ
鲕	鱼而一丿丨ㄋ	鱼而一丿丨ㄋ
鳂	鱼田一ㄋ丿丶	鱼田一ㄋ丿丶
颥	而一丿丨ㄋ	而一丿丨ㄋ
胲	月亥丶一ㄋ丿	月亥丶一ㄋ丿
腘	月口一一丨一	月口一一丨一
胠	月去一丨一ㄋ	月去一丨一ㄋ
艎	舟白一一丨一	舟白一一丨一
隃	耳亼丨ㄋ一一	耳亼丨ㄋ一一
耰	未石丨ㄋ一一	未石丨ㄋ一一
簉	告丶ㄋ丶丶	告丶ㄋ丶丶
糒	米共丿丿ㄋ一	米共丿丿ㄋ一
讻	讠乂ㄋ丨丨丨	讠乂ㄋ丨丨丨
蓢	艹笔ㄋ一一ㄋ	艹笔ㄋ一一ㄋ
叇	云尹丨丶一丿	云尹丨丶一丿
嘚	口彳丨ㄋ一一	口彳丨ㄋ一一
噀	口巴ㄋ一ㄋ一	口巴ㄋ一ㄋ一
坬	土爪丿丿ㄋ丶	土爪丿丿ㄋ丶
埵	土垂丿一丨一	土垂丿一丨一
慆	忄爪丿丨一ㄋ	忄爪丿丨一ㄋ
棬	木ㄋㄋㄋㄋ	木ㄋㄋㄋㄋ
椑	木卑丿丨ㄋ一	木卑丿丨ㄋ一
殣	歹堇一丨丨一	歹堇一丨丨一
涘	氵厶丿一一丿	氵厶丿一一丿
湉	氵忄丿一丨丨	氵忄丿一丨丨
玃	犬目丨ㄋ一一	犬目丨ㄋ一一
甦	更生丿一一丨	更生丿一一丨
邶	北耳ㄋ丨丨丨	北耳ㄋ丨丨丨
郈	广鬲ㄋ丨丨丨	广鬲ㄋ丨丨丨
簖	米ㄋ丿丿一	米ㄋ丿丿一
筻	更一丨ㄋ一	更一丨ㄋ一
蹜	宀丿丶一丿	宀丿丶一丿
赕	贝火丶丿丿丶	贝火丶丿丿丶
蓰	艹彳丨一丨一	艹彳丨一丨一
茳	落工一丨一一	落工一丨一一
茼	艹冂一丨ㄋ一	艹冂一丨ㄋ一
蔊	艹火丨ㄋ一一	艹火丨ㄋ一一
辒	车日丨ㄋ丨丨	车日丨ㄋ丨丨
衠	彳直丿丶一一	彳直丿丶一一
蟫	虫西丨ㄋ一一	虫西丨ㄋ一一
鄹	耳双丿丨丿丿	耳双丿丨丿丿
廾	开一丿丨丨丨	开一丿丨丨丨
鹙	禾火丿ㄋ丶ㄋ	禾火丿ㄋ丶ㄋ
燏	火矛丨ㄋ丿丶	火矛丨ㄋ丿丶
缏	纟亻一丨ㄋ一	纟亻一丨ㄋ一
绤	纟八丿丶丨ㄋ	纟八丿丶丨ㄋ
铚	金至一ㄋ丶一	金至一ㄋ丶一
哳	口折一丨一丿	口折一丨一丿
喤	口白一一丨一	口白一一丨一
慭	夹来一丿丶丶	夹来一丿丶丶
惎	其心丶ㄋ丶丶	其心丶ㄋ丶丶
澉	氵㇉一丨丨一	氵Z一丨丨一
沲	氵ㄋ丨ㄋㄋ	氵ㄋ丨ㄋㄋ
馉	食骨丨ㄋㄋ丶	食骨丨ㄋㄋ丶
饳	食山ㄋ丨丨丨	食山ㄋ丨丨丨
攉	扌丿丨丶一	扌丿丨丶一
坶	土母ㄋㄋ丶一	土母ㄋㄋ丶一
珌	王心丿丿丿丿	王心丿丿丿丿
鹯	亠回丨ㄋ一一	亠回丨ㄋ一一
敔	五口丿一丿丶	五口丿一丿丶
鲴	鱼口一丨丨ㄋ	鱼口一丨丨ㄋ
鲌	鱼白丿丨ㄋ一	鱼白丿丨ㄋ一
遹	矛冂丿丶丨ㄋ	矛冂丿丶丨ㄋ
臜	月先丿一丨一	月先丿一丨一
朏	月山ㄋ丨丨丨	月山ㄋ丨丨丨
舭	舟比一ㄋ丿ㄋ	舟比一ㄋ丿ㄋ
趯	走羽丿丨丶一	走羽丿丨丶一
陧	耳日一丨一一	耳日一丨一一
陞	耳笔一丿丨一	耳笔一丿丨一
佽	亻次丶一丿ㄋ	亻次丶一丿ㄋ
偓	亻尸一ㄋ丶一	亻尸一ㄋ丶一
偭	亻面一丿丨ㄋ	亻面一丿丨ㄋ
僰	朿朿丿丶丶丶	朿朿丿丶丶丶
垞	土宀丿一ㄋㄋ	土宀丿一ㄋㄋ
塅	土段丿丨一一	土段丿丨一一
嬿	女甘丨ㄋ一丶	女甘丨ㄋ一丶
帡	巾䒑一丿丨丨	巾首一丿丨丨
悢	忄笔ㄋ一一ㄋ	忄笔ㄋ一一ㄋ
捯	扌至丨丨丨丨	扌至丨丨丨丨
斠	共冂一丨一丶	共冂一丨一丶
旐	方丿ㄋ丶一	方丿ㄋ丶一
昒	日勿丿ㄋ丿丿	日勿丿ㄋ丿丿
晫	日卜丨ㄋ一一	日卜丨ㄋ一一
柷	木口丿ㄋㄋㄋ	木口丿ㄋㄋㄋ
棁	木𠮦丿ㄋㄋㄋ	木兑丿ㄋㄋㄋ
洺	氵歹丨ㄋ一一	氵歹丨ㄋ一一
淜	氵月丿ㄋ一一	氵月丿ㄋ一一
滫	氵亻丿一丿丶	氵亻丿一丿丶
澛	氵鱼丨ㄋ一一	氵鱼丨ㄋ一一
焞	火ㄋ丨一一	火ㄋ丨一一
璈	王敖一一丨一	王敖一一丨一
堨	土日丿ㄋ丿丶	土日丿ㄋ丿丶
虒	广虍丿ㄋㄋㄋ	广虍丿ㄋㄋㄋ
鳘	母丿一丿丶	母丿一丿丶
羖	羊殳丿ㄋㄋ丶	羊殳丿ㄋㄋ丶
踺	聿ㄋ丶丶丶	聿ㄋ丶丶丶
鄫	曾耳ㄋ丨丨丨	曾耳ㄋ丨丨丨
鹎	卑鸟丿ㄋ丶ㄋ	卑鸟丿ㄋ丶ㄋ
痦	疒五丨ㄋ一一	疒五丨ㄋ一一
蕻	艹长一丨丨一	艹长一丨丨一
菂	艹白丿ㄋ丶丶	艹白丿ㄋ丶丶
蒟	艹立丿ㄋ丨ㄋ	艹立丿ㄋ丨ㄋ
芼	艹毛丿一一ㄋ	艹毛丿一一ㄋ
鬒	长直丿丶丶丶	长直丿丶丶丶
蝘	虫匚丨ㄋ一一	虫匚丨ㄋ一一
倞	亻京丶一丨ㄋ	亻京丶一丨ㄋ
偰	亻丰ㄋ丿一丿	亻丰ㄋ丿一丿
繄	匚矢丿ㄋㄋ丶	匚矢丿ㄋㄋ丶
稌	禾亼一丨丿丶	禾亼一丨丿丶
扊	户火丶丿丿丶	户火丶丿丿丶
煴	火日丨ㄋ丨丨	火日丨ㄋ丨丨
铞	金口丨ㄋ丨丨	金口丨ㄋ丨丨
钆	金乙ㄋㄋㄋㄋ	金乙ㄋㄋㄋㄋ
镃	金䒑ㄋㄋ丶ㄋ	金首ㄋㄋ丶ㄋ
锧	金广一丨丿丶	金广一丨丿丶
鼢	鼠分丿丶ㄋ丿	鼠分丿丶ㄋ丿
咇	口心丿丿丿丿	口心丿丿丿丿
耔	未子ㄋ丨一一	未子ㄋ丨一一
榍	木尸丨丶丿丨	木尸丨丶丿丨
眍	目区一丿丶ㄋ	目区一丿丶ㄋ
牿	牛告丿一丨一	牛告丿一丨一
姤	女广一丨ㄋ一	女广一丨ㄋ一
昈	日户丶ㄋ一丿	日户丶ㄋ一丿
洚	氵文一ㄋ丨丨	氵文一ㄋ丨丨
滗	氵丿一一ㄋ	氵丿一一ㄋ
薢	氵角ㄋ丿丿一	氵角ㄋ丿丿一
湑	氵走丨ㄋ一一	氵走丨ㄋ一一
翙	山歹ㄋ丶一ㄋ	山歹ㄋ丶一ㄋ
岞	山乍丿一丨一	山乍丿一丨一
屃	尸贝丨ㄋ丿丶	尸贝丨ㄋ丿丶
磉	石双ㄋ丶ㄋ丶	石双ㄋ丶ㄋ丶
砘	石屯一ㄋ丨ㄋ	石屯一ㄋ丨ㄋ
祏	衤石一丿丨ㄋ	衤石一丿丨ㄋ
禔	衤日丨ㄋ一一	衤日丨ㄋ一一
掭	扌天丨丶丶丶	扌天丨丶丶丶
搛	扌兼丶丿一ㄋ	扌兼丶丿一ㄋ
堍	土象丿ㄋ丶丶	土象丿ㄋ丶丶
玚	王㇉丿丿丿丿	王Z丿丿丿丿
迺	西辶丶ㄋ丶丶	西辶丶ㄋ丶丶
邲	心笔ㄋ丨丨丨	心笔ㄋ丨丨丨
窎	穴鸟丿ㄋ丶ㄋ	穴鸟丿ㄋ丶ㄋ
讱	讠刀丶丶丶丶	讠刀丶丶丶丶
鲩	鱼宀一一丿ㄋ	鱼宀一一丿ㄋ
鲒	鱼吉一丨一丨	鱼吉一丨一丨
鳠	鱼艹丿丨丶一	鱼艹丿丨丶一
腽	月日丨ㄋ丨丨	月日丨ㄋ丨丨
膣	月穴一ㄋ丶一	月穴一ㄋ丶一
脿	月丰丿ㄋ丿丶	月丰丿ㄋ丿丶
疍	走旦丨ㄋ一一	走旦丨ㄋ一一
鼽	自田丿ㄋㄋㄋ	自田丿ㄋㄋㄋ
蹢	立丨ㄋ一丨	立丨ㄋ一丨
鞁	革皮ㄋ丿丨ㄋ	革皮ㄋ丿丨ㄋ
倓	亻火丶丿丿丶	亻火丶丿丿丶
冮	冫工一丨一一	冫工一丨一一
勚	甘乙丨ㄋ丿丶	甘乙丨ㄋ丿丶
奡	石目一丿丶丿	石目一丿丶丿
奭	大笔丿丨ㄋ一	大笔丿丨ㄋ一
姞	女吉一丨一丨	女吉一丨一丨
娀	女戋一丿丿丿	女戋一丿丿丿
娵	女耳ㄋ丶丶丶	女耳ㄋ丶丶丶
婘	女ㄋㄋㄋㄋ	女ㄋㄋㄋㄋ
媭	川页ㄋ丿一一	川页ㄋ丿一一
嫄	女广丿丨ㄋ一	女广丿丨ㄋ一
嫕	女匚丿一一丿	女匚丿一一丿
孖	子子ㄋ丨一一	子子ㄋ丨一一
庼	广七一丿丨ㄋ	广七一丿丨ㄋ
忞	文心丶ㄋ丶丶	文心丶ㄋ丶丶
晙	日厶丿丶丿ㄋ	日厶丿丶丿ㄋ
柊	木文丶丶丶丶	木文丶丶丶丶
梿	木车丶ㄋ丶丶	木车丶ㄋ丶丶
棫	木戋丨ㄋ一一	木戋丨ㄋ一一
槱	木西丶丶丶丶	木西丶丶丶丶
汋	氵勹丶丶丶丶	氵勹丶丶丶丶
浉	氵刂一丨ㄋ丨	氵刂一丨ㄋ丨
瀍	氵广丨ㄋ一一	氵广丨ㄋ一一
焗	火尸ㄋ丨ㄋ一	火尸ㄋ丨ㄋ一
犨	隹隹丿一一丨	隹隹丿一一丨
玘	王巴ㄋ一ㄋㄋ	王巴ㄋ一ㄋㄋ
玡	王牙一ㄋ丨丿	王牙一ㄋ丨丿
琫	王一一丨丨	王一一丨丨
琲	王非丨一一一	王非丨一一一
璪	王口丨ㄋ一丨	王口丨ㄋ一丨
皭	白爪丨ㄋ丨丨	白爪丨ㄋ丨丨
傢	亻宀一丿ㄋ丿	亻宀一丿ㄋ丿
薿	艹七丿一一丿	艹七丿一一丿
鹛	尸目丿ㄋ丶ㄋ	尸目丿ㄋ丶ㄋ
鄗	口ㄋ丨丨丨	口ㄋ丨丨丨
悆	亼木丶ㄋ丶丶	亼木丶ㄋ丶丶
埇	土甬ㄋ丶丨ㄋ	土甬ㄋ丶丨ㄋ
筢	扌ㄋ丨一ㄋ	扌ㄋ丨一ㄋ
箢	宀丿ㄋ丶ㄋ	宀丿ㄋ丶ㄋ
筀	圭一丨一一	圭一丨一一
羑	羊久丿ㄋ丶丶	羊久丿ㄋ丶丶
桊	木一丨丿丶	木一丨丿丶
踒	禾ㄋ丿一一	禾ㄋ丿一一
瘊	疒亻ㄋ一丿一	疒亻ㄋ一丿一
疰	疒主丶一一丨	疒主丶一一丨
菥	艹木丿丿一丨	艹木丿丿一丨
蒇	艹戊丨ㄋ丿丶	艹戊丨ㄋ丿丶
蕹	艹亠ㄋㄋ丿丿	艹亠ㄋㄋ丿丿
苠	艹民ㄋ一ㄋ一	艹民ㄋ一ㄋ一
蕗	艹丿ㄋ丶丨	艹丿ㄋ丶丨
藠	艹白丿丨ㄋ一	艹白丿丨ㄋ一
蘘	艹亠丨ㄋ一丨	艹亠丨ㄋ一丨
萚	艹扌ㄋ丶一一	艹扌ㄋ丶一一
髢	长也ㄋ丨ㄋㄋ	长也ㄋ丨ㄋㄋ
鸻	彳于丿ㄋ丶ㄋ	彳于丿ㄋ丶ㄋ
傺	亻一一丨丿	亻祭一一丨丿
佴	亻耳一丨丨一	亻耳一丨丨一
儦	亻鹿丶丶丶丶	亻鹿丶丶丶丶
猃	犬亼丶丶丿一	犬亼丶丶丿一
猇	犬虍丿ㄋㄋㄋ	犬虍丿ㄋㄋㄋ
匼	匚合丿丶一丨	匚合丿丶一丨
靰	革笔丿ㄋㄋㄋ	革笔丿ㄋㄋㄋ
鹀	工从丿ㄋ丶ㄋ	工从丿ㄋ丶ㄋ
艴	弓刂丿ㄋㄋ丨	弓刂丿ㄋㄋ丨
鹒	广尹丿丶丿ㄋ	广尹丿丶丿ㄋ
稑	禾土丿丶一丨	禾土丿丶一丨
稙	禾直一丨丨ㄋ	禾直一丨丨ㄋ
甗	虍鬲一ㄋㄋ丶	虍鬲一ㄋㄋ丶
扅	户歹丿ㄋ丶丶	户歹丿ㄋ丶丶
觭	角大一丨ㄋ一	角大一丨ㄋ一
锎	金门一一丿丨	金门一一丿丨
镩	金宀丿丶丶丶	金宀丿丶丶丶
镲	金宀丿ㄋ丶丶	金宀丿ㄋ丶丶
镱	金音丶ㄋ丶丶	金音丶ㄋ丶丶
镨	金䒑丨丨丶丿	金首丨丨丶丿
锬	金火丶丿丿丶	金火丶丿丿丶
镚	金山丿ㄋ一一	金山丿ㄋ一一
嚄	口艹丿丨丶一	口艹丿丨丶一
耥	未丨ㄋ丨ㄋ	未丨ㄋ丨ㄋ
耩	未共丨ㄋ一丨	未共丨ㄋ一丨
麀	鹿七丿ㄋㄋㄋ	鹿七丿ㄋㄋㄋ
骃	马因丨ㄋ一丿	马因丨ㄋ一丿
骕	马聿丿丶丿丨	马聿丿丶丿丨
氇	毛鱼丨ㄋ一一	毛鱼丨ㄋ一一
氆	毛䒑丨丨丶丿	毛首丨丨丶丿
梠	木口丨ㄋ一一	木口丨ㄋ一一
棽	林令丿丶丶ㄋ	林令丿丶丶ㄋ
榑	木甫一丨丶丶	木甫一丨丶丶
戤	乃双丨ㄋ丨丨	乃双丨ㄋ丨丨
砮	奴石一丿丨ㄋ	奴石一丿丨ㄋ
弆	去开一丿丨丨	去开一丿丨丨
昫	日勹丨ㄋ一一	日勹丨ㄋ一一
溻	氵日ㄋ丶一ㄋ	氵日ㄋ丶一ㄋ
汧	氵开一一丿丨	氵开一一丿丨
漻	氵羽丿丶丿丿	氵羽丿丶丿丿
嶓	山釆丨ㄋ一丨	山釆丨ㄋ一丨
礓	石笔丨ㄋ一丨	石笔丨ㄋ一丨
礤	石艹丿ㄋ丶丶	石艹丿ㄋ丶丶
碃	石青一一丨一	石青一一丨一
磹	石西丨ㄋ一一	石西丨ㄋ一一
碨	石田一ㄋ丿丶	石田一ㄋ丿丶
憭	忄大丶丶丨ㄋ	忄大丶丶丨ㄋ
搌	扌尸一丨丨一	扌尸一丨丨一
揞	扌立丨ㄋ一一	扌立丨ㄋ一一
鬷	鬲乂ㄋ丨ㄋ丶	鬲乂ㄋ丨ㄋ丶
埯	土大丨ㄋ一一	土大丨ㄋ一一
玼	王此丨一丨一	王此丨一丨一
圌	口山一丿丨ㄋ	口山一丿丨ㄋ
袗	衤人丿丿丿丿	衤人丿丿丿丿
酦	西发ㄋ丿ㄋ丶	西发ㄋ丿ㄋ丶
鳈	鱼白丨ㄋ丿丶	鱼白丨ㄋ丿丶
鳒	鱼兼丶丿一ㄋ	鱼兼丶丿一ㄋ
鲾	鱼鬲丨ㄋ一丨	鱼鬲丨ㄋ一丨
腙	月宀一一丨丿	月宀一一丨丿
腒	月尸一丨丨ㄋ	月尸一丨丨ㄋ
盉	禾四丨ㄋ丨丨	禾四丨ㄋ丨丨
鲖	鱼冂一丨ㄋ一	鱼冂一丨ㄋ一
祊	衤方丶一ㄋ丿	衤方丶一ㄋ丿
矼	石工一丨一一	石工一丨一一
纼	纟弓丨丨丨丨	纟弓丨丨丨丨
菼	艹火丶丿丿丶	艹火丶丿丿丶
筤	笔ㄋ一一ㄋ	笔ㄋ一一ㄋ
耏	而川丿丿丿丿	而川丿丿丿丿
鸤	尸鸟丿ㄋ丶ㄋ	尸鸟丿ㄋ丶ㄋ
竫	立争丿ㄋㄋ一	立争丿ㄋㄋ一
蟏	虫艹ㄋ一一丨	虫艹ㄋ一一丨
萹	艹户丨ㄋ一丨	艹户丨ㄋ一丨
蝲	虫束丨丨丨丨	虫束丨丨丨丨
侁	亻先丿一丨一	亻先丿一丨一
侂	亻广丿一ㄋㄋ	亻广丿一ㄋㄋ
侘	亻宀丿一ㄋㄋ	亻宀丿一ㄋㄋ
偁	亻爪丨ㄋ一丨	亻爪丨ㄋ一丨
傉	亻辰一丨丶丶	亻辰一丨丶丶
劼	吉力ㄋ丿丿丿	吉力ㄋ丿丿丿
勔	面力ㄋ丿丿丿	面力ㄋ丿丿丿
匜	匚也ㄋ丨ㄋㄋ	匚也ㄋ丨ㄋㄋ
哱	口十丶ㄋㄋ丨	口十丶ㄋㄋ丨
啴	口单丶丿丨ㄋ	口单丶丿丨ㄋ
噂	口酋一丨丶丶	口酋一丨丶丶
堉	土亡丨ㄋ一一	土亡丨ㄋ一一
堲	卩一丨一一	卩一丨一一
妧	女元一一丿ㄋ	女元一一丿ㄋ
婌	女上丨丿丶ㄋ	女上丨丿丶ㄋ
婼	女艹一丿丨ㄋ	女艹一丿丨ㄋ
宬	宀戊ㄋㄋㄋㄋ	宀戊ㄋㄋㄋㄋ
峘	山笔丨ㄋ一一	山笔丨ㄋ一一
崀	山笔ㄋ一一ㄋ	山笔ㄋ一一ㄋ
嵁	山其ㄋㄋㄋㄋ	山其ㄋㄋㄋㄋ
嶲	山隹丨ㄋ丨丨	山隹丨ㄋ丨丨
弸	弓月丿ㄋ一一	弓月丿ㄋ一一
摴	扌一一ㄋㄋ	扌一一ㄋㄋ
昳	日笔一一丿丶	日笔一一丿丶
朓	月儿丶一丿丶	月儿丶一丿丶
杕	木大一丿丶丶	木大一丿丶丶
桯	木口一一丨一	木口一一丨一
桹	木笔ㄋ一一ㄋ	木笔ㄋ一一ㄋ
楩	木亻一丨ㄋ一	木亻一丨ㄋ一
榰	木者丿ㄋ丨ㄋ	木者丿ㄋ丨ㄋ
泙	氵平一丶丿一	氵平一丶丿一
泜	氵氏丶丶丶丶	氵氏丶丶丶丶
湴	氵䒑丨丨丶丿	氵首丨丨丶丿
漦	未文一丿丨ㄋ	未文一丿丨ㄋ
漼	氵山丿丨丶一	氵山丿丨丶一
澼	氵辟ㄋ一丿丨	氵辟ㄋ一丿丨
焌	火厶丿丶丿ㄋ	火厶丿丶丿ㄋ
爟	火艹丨ㄋ一丨	火艹丨ㄋ一丨
牁	片可一丨ㄋ一	片可一丨ㄋ一
狉	犬不一一一一	犬不一一一一
猺	犬爪丿一一丨	犬爪丿一一丨
獴	犬萝一一丿ㄋ	犬萝一一丿ㄋ
珽	王笔丨一丨一	王笔丨一丨一
瑀	王笔丨ㄋ一丨	王笔丨ㄋ一丨
甡	生生丿一一丨	生生丿一一丨
骉	马马ㄋㄋ一一	马马ㄋㄋ一一
囧	口八丨ㄋㄋㄋ	口八丨ㄋㄋㄋ
檵	木幺ㄋㄋ丶一	木幺ㄋㄋ丶一
鹠	留田丿ㄋ丶ㄋ	留田丿ㄋ丶ㄋ
塝	土立丶一ㄋ丿	土立丶一ㄋ丿
墈	土其ㄋㄋ丿丿	土其ㄋㄋ丿丿
垕	广鬲一丨一一	广鬲一丨一一
黇	共甲丿丶丨一	共甲丿丶丨一
筘	扌丨ㄋ一一	扌丨ㄋ一一
鹟	公羽丿ㄋ丶ㄋ	公羽丿ㄋ丶ㄋ
谼	八人丨ㄋ一一	八人丨ㄋ一一
瘭	疒西一一丨丿	疒西一一丨丿
葙	艹相一丨丿丶	艹相一丨丿丶
葰	荷厶丿丶丿ㄋ	荷厶丿丶丿ㄋ
蓇	艹骨丨ㄋㄋ丶	艹骨丨ㄋㄋ丶
蓏	艹爪丿丿ㄋ丶	艹爪丿丿ㄋ丶
薳	艹吉丿ㄋ丿丶	艹吉丿ㄋ丿丶
荖	艹者丿ㄋㄋㄋ	艹者丿ㄋㄋㄋ
藦	艹麻丿一一丨	艹麻丿一一丨
葖	艹穴一丿丶丶	艹穴一丿丶丶
莙	艹尹丨ㄋ一一	艹尹丨ㄋ一一
薁	艹丶丿一丨	艹丶丿一丨
轪	车大一丿丶丶	车大一丿丶丶
螵	虫西一一丨丿	虫西一一丨丿
螠	虫䒑丿丶丨ㄋ	虫首丿丶丨ㄋ
蚄	虫方丶一ㄋ丿	虫方丶一ㄋ丿
虸	虫子ㄋ丨一一	虫子ㄋ丨一一
伭	亻亠ㄋㄋ丶丶	亻亠ㄋㄋ丶丶
佖	亻心丿丿丿丿	亻心丿丿丿丿
俙	亻乂丨ㄋ丨丨	亻乂丨ㄋ丨丨
儴	亻亠丨ㄋ一丨	亻亠丨ㄋ一丨
攽	分文丿一丿丶	分文丿一丿丶
穜	禾立丨ㄋ一一	禾立丨ㄋ一一
穄	禾一一丨丿	禾祭一一丨丿
觟	角圭一丨一一	角圭一丨一一
钶	金于丨ㄋ一一	金于丨ㄋ一一
铴	金氵ㄋ丿丿丿	金氵ㄋ丿丿丿
镥	金鱼丨ㄋ一一	金鱼丨ㄋ一一
锘	金艹一丿丨ㄋ	金艹一丿丨ㄋ
锫	金立丨ㄋ一一	金立丨ㄋ一一
镤	金业丶丿一一	金业丶丿一一
铕	金石丨ㄋ一一	金石丨ㄋ一一
钘	金开一一丿丨	金开一一丿丨
铻	金五丨ㄋ一一	金五丨ㄋ一一
鼫	鼠石一丿丨ㄋ	鼠石一丿丨ㄋ
咥	口至一ㄋ丶一	口至一ㄋ丶一
嘡	口一丨一一	口一丨一一
耱	未麻一丿丨ㄋ	未麻一丿丨ㄋ
耤	未共丨ㄋ一一	未共丨ㄋ一一
骣	马尸ㄋ丨一ㄋ	马尸ㄋ丨一ㄋ
骙	马一一丿丶	马祭一一丿丶
榀	木口丨ㄋ一丨	木口丨ㄋ一丨
楱	木一一丿丶	木一一丿丶
睄	目丨ㄋ一一	目丨ㄋ一一
犋	牛目丿丶丶丶	牛目丿丶丶丶
姽	女厃ㄋㄋㄋㄋ	女厃ㄋㄋㄋㄋ
嬥	女羽丿丨丶一	女羽丿丨丶一
嬬	女一丿丨ㄋ	女一丿丨ㄋ
隺	冖隹丿丨丶一	冖隹丿丨丶一
凵	冂ㄋ丨丨丨丨	冂ㄋ丨丨丨丨
颋	王辶一丿丨ㄋ	王辶一丿丨ㄋ
旴	日于一一丨丨	日于一一丨丨
晐	日亥丶一ㄋ丿	日亥丶一ㄋ丿
峗	山厃ㄋㄋㄋㄋ	山厃ㄋㄋㄋㄋ
峿	山五丨ㄋ一一	山五丨ㄋ一一
螱	尸示一丨丶丨	尸示一丨丶丨
磲	石氵一ㄋㄋ一	石氵一ㄋㄋ一
礞	石萝一一丿ㄋ	石萝一一丿ㄋ
磜	石一一丨丿	石祭一一丨丿
硊	石厃ㄋㄋㄋㄋ	石厃ㄋㄋㄋㄋ
砫	石主丶一一丨	石主丶一一丨
碏	石共丨ㄋ一一	石共丨ㄋ一一
磏	石兼丶丿一ㄋ	石兼丶丿一ㄋ
搋	扌广丨一ㄋ丿	扌广丨一ㄋ丿
扺	扌氏丿ㄋ一ㄋ	扌氏丿ㄋ一ㄋ
墚	土氵ㄋ丿一丨	土氵ㄋ丿一丨
塥	土鬲一丨ㄋ一	土鬲一丨ㄋ一
玱	王人ㄋㄋㄋㄋ	王人ㄋㄋㄋㄋ
珷	王笔一ㄋ丶丨	王笔一ㄋ丶丨
琄	王口丨ㄋ一一	王口丨ㄋ一一
璲	王冫一丿ㄋ丿	王冫一丿ㄋ丿
郪	笔聿ㄋ丿一ㄋ	笔聿ㄋ丿一ㄋ
袯	衤发ㄋ丿ㄋ丶	衤发ㄋ丿ㄋ丶
瓻	乂巾一ㄋㄋ丶	乂巾一ㄋㄋ丶
鳋	鱼双丶丨ㄋ一	鱼双丶丨ㄋ一
鳁	鱼日丨ㄋ丨丨	鱼日丨ㄋ丨丨
鲪	鱼尹丨ㄋ一一	鱼尹丨ㄋ一一
鳛	鱼羽丿丨ㄋ一	鱼羽丿丨ㄋ一
鱽	鱼刀ㄋ丿丿丿	鱼刀ㄋ丿丿丿
翂	羽分丿丶ㄋ丿	羽分丿丶ㄋ丿
艅	舟亼一丨丿丶	舟亼一丨丿丶
劁	隹水丨丨丨丨	隹水丨丨丨丨
齄	自田一丨丿丶	自田一丨丿丶
阢	耳笔丿ㄋㄋㄋ	耳笔丿ㄋㄋㄋ
襫	衤大一丿丨ㄋ	衤大一丿丨ㄋ
鄅	笔口丨ㄋ丨一	笔口丨ㄋ丨一
芣	艹不一丿丨丶	艹不一丿丨丶
靽	革半丶丿一一	革半丶丿一一
骦	马一丨丿丶	马一丨丿丶
靬	革舌一一丨丨	革舌一一丨丨
荓	艹䒑一丿丨丨	艹首一丿丨丨
硿	石穴一丨一一	石穴一丨一一
笯	女ㄋ丶丶丶	女ㄋ丶丶丶
衃	扌笔丨ㄋ丨丨	扌笔丨ㄋ丨丨
褟	衤日ㄋ丶一ㄋ	衤日ㄋ丶一ㄋ
砆	石夫一一丿丶	石夫一一丿丶
硍	石艮ㄋ一一ㄋ	石艮ㄋ一一ㄋ
蔈	艹西一一丨丿	艹西一一丨丿
礵	石一丨丿丶	石一丨丿丶
齇	自田丨一ㄋ丿	自田丨一ㄋ丿
丏	正㇉ㄋㄋㄋㄋ	正Zㄋㄋㄋㄋ
伾	亻不一一一一	亻不一一一一
俍	亻笔ㄋ一一ㄋ	亻笔ㄋ一一ㄋ
倧	亻宀一一丨丿	亻宀一一丨丿
倴	亻大一丨一丿	亻大一丨一丿
僎	亻巴ㄋ一ㄋ一	亻巴ㄋ一ㄋ一
冔	日口一一丨丨	日口一一丨丨
凓	冫西一丨丿丶	冫西一丨丿丶
剕	非刂丨丨丨丨	非刂丨丨丨丨
叚	叚ㄋ一丨一一	叚ㄋ一丨一一
咡	口耳一丨丨一	口耳一丨丨一
咺	口笔丨ㄋ一一	口笔丨ㄋ一一
垍	土自丿丨ㄋ一	土自丿丨ㄋ一
婳	女笔丨ㄋ一丨	女笔丨ㄋ一丨
媄	女羊一丿丶丶	女羊一丿丶丶
媆	女而一丿丶丶	女而一丿丶丶
媱	女爪丿一一丨	女爪丿一一丨
嫭	女虍丿丶丿一	女虍丿丶丿一
岊	巴山丨ㄋ丨丨	巴山丨ㄋ丨丨
峃	山丨ㄋ丨丨	山丨ㄋ丨丨
峧	山六丿丶丶丶	山六丿丶丶丶
嵲	山自一丨丿丶	山自一丨丿丶
幖	巾西一一丨丿	巾西一一丨丿
憙	壴口丶ㄋ丶丶	壴口丶ㄋ丶丶
拤	扌上丨丶丶丶	扌上丨丶丶丶
摏	扌丿丨一ㄋ	扌丿丨一ㄋ
敩	子丿一丿丶	子丿一丿丶
栟	木䒑一丿丨丨	木首一丿丨丨
栻	木戋一丨一一	木戋一丨一一
桲	木十丶ㄋㄋ丨	木十丶ㄋㄋ丨
梴	木笔丨一丨一	木笔丨一丨一
梽	木土丶ㄋ丶丶	木土丶ㄋ丶丶
椸	木族ㄋ丨ㄋㄋ	木族ㄋ丨ㄋㄋ
欂	木落一丨ㄋ一	木落一丨ㄋ一
汭	氵内丨ㄋ丿丶	氵内丨ㄋ丿丶
沺	氵田丨ㄋ一丨	氵田丨ㄋ一丨
洴	氵䒑一丿丨丨	氵首一丿丨丨
浕	氵尺丶丶丶丶	氵尺丶丶丶丶
浰	氵禾丨丨丨丨	氵禾丨丨丨丨
淟	氵甲丿丶丶丶	氵甲丿丶丶丶
淴	氵勿丶ㄋ丶丶	氵勿丶ㄋ丶丶
澂	氵山一丿一丿	氵山一丿一丿
炟	火旦丨ㄋ一一	火旦丨ㄋ一一
烻	火笔丨一丨一	火笔丨一丨一
煟	火田丿ㄋ一一	火田丿ㄋ一一
牚	牙一ㄋ丨丿	牙一ㄋ丨丿
玙	王与一一一一	王与一一一一
玞	王夫一一丿丶	王夫一一丿丶
玭	王比一ㄋ丿ㄋ	王比一ㄋ丿ㄋ
珝	王羽ㄋ丶一ㄋ	王羽ㄋ丶一ㄋ
珫	王亡丿ㄋㄋㄋ	王亡丿ㄋㄋㄋ
瓖	王亠丨ㄋ一丨	王亠丨ㄋ一丨
蛃	虫丙丿丶丶丶	虫丙丿丶丶丶
揾	扌日丨ㄋ丨丨	扌日丨ㄋ丨丨
俬	亻禾ㄋ丶丶丶	亻禾ㄋ丶丶丶
攴	卜双ㄋ丶丶丶	卜双ㄋ丶丶丶
遆	立巾丶ㄋ丶丶	立巾丶ㄋ丶丶
坋	土分丿丶ㄋ丿	土分丿丶ㄋ丿
垎	土各丿ㄋ丶丨	土各丿ㄋ丶丨
垯	土大丶ㄋ丶丶	土大丶ㄋ丶丶
堎	土厶丿丶丿ㄋ	土厶丿丶丿ㄋ
墣	土业丶丿一一	土业丶丿一一
箖	林一丨丿丶	林一丨丿丶
筼	口丨ㄋ丿丶	口丨ㄋ丿丶
筶	告丿一丨一	告丿一丨一
簝	大丶丶丨ㄋ	大丶丶丨ㄋ
筜	ㄋ一一一	ㄋ一一一
鲝	羊鱼丿ㄋ丨ㄋ	羊鱼丿ㄋ丨ㄋ
蹾	ㄋ丨一丿	ㄋ丨一丿
蹽	大丶丶丨ㄋ	大丶丶丨ㄋ
宧	宀臣一丨丨ㄋ	宀臣一丨丨ㄋ
痃	疒亠ㄋㄋ丶丶	疒亠ㄋㄋ丶丶
痄	疒乍丿一丨一	疒乍丿一丨一
痓	疒至一ㄋ丶一	疒至一ㄋ丶一
荮	艹纟一丨丶丶	艹纟一丨丶丶
蒈	艹比丿丨ㄋ一	艹比丿丨ㄋ一
菍	艹令丶ㄋ丶丶	艹令丶ㄋ丶丶
茽	荷中丨ㄋ一丨	荷中丨ㄋ一丨
荙	艹大丶ㄋ丶丶	艹大丶ㄋ丶丶
茓	艹穴丶丶ㄋ丿	艹穴丶丶ㄋ丿
轷	车乎丿丶丿一	车乎丿丶丿一
軎	车口丨ㄋ一一	车口丨ㄋ一一
蟓	虫象丿ㄋ丨ㄋ	虫象丿ㄋ丨ㄋ
蜐	虫去ㄋ丿丿丿	虫去ㄋ丿丿丿
牮	代牛丿一一丨	代牛丿一一丨
伣	亻见丨ㄋ丿ㄋ	亻见丨ㄋ丿ㄋ
侹	亻王ㄋ丶丶丶	亻王ㄋ丶丶丶
俫	亻夹丨丿丶丶	亻夹丨丿丶丶
猸	犬尸丨ㄋ一一	犬尸丨ㄋ一一
猹	犬木丨ㄋ一一	犬木丨ㄋ一一
猄	犬京丶一丨ㄋ	犬京丶一丨ㄋ
猯	犬山一丿丨ㄋ	犬山一丿丨ㄋ
鞧	革酋丶丿一丨	革酋丶丿一丨
韂	革厃丿丶丶一	革厃丿丶丶一
弪	弓轻ㄋ丶一丨	弓轻ㄋ丶一丨
弶	弓京丶一丨ㄋ	弓京丶一丨ㄋ
髃	骨日丨ㄋ丨一	骨日丨ㄋ丨一
鄘	广聿丿ㄋ一一	广聿丿ㄋ一一
廆	广鬼丿丨ㄋ一	广鬼丿丨ㄋ一
虍	虍丨一ㄋ丿一	虍丨一ㄋ丿一
虤	虍几丨一ㄋ丿	虍几丨一ㄋ丿
扂	户占丨一丨ㄋ	户占丨一丨ㄋ
烶	火王ㄋ丶丶丶	火王ㄋ丶丶丶
翈	甲羽ㄋ丶一ㄋ	甲羽ㄋ丶一ㄋ
缐	纟白丨ㄋ丿丶	纟白丨ㄋ丿丶
斶	丘四丿ㄋ丨ㄋ	丘四丿ㄋ丨ㄋ
钸	金石丨ㄋ丨丨	金石丨ㄋ丨丨
钷	金匚丨ㄋ一一	金匚丨ㄋ一一
铽	金戋丶ㄋ丶丶	金戋丶ㄋ丶丶
镎	金合丿一一丨	金合丿一一丨
锖	金青一一丨一	金青一一丨一
铹	金萝ㄋ丿丿丿	金萝ㄋ丿丿丿
铥	金笔一丨一ㄋ	金笔一丨一ㄋ
訄	九讠丶一一一	九讠丶一一一
鼩	鼠勹丨ㄋ一一	鼠勹丨ㄋ一一
嚆	口艹丶一丨ㄋ	口艹丶一丨ㄋ
噇	口立丨ㄋ一一	口立丨ㄋ一一
耠	未合丿丶一丨	未合丿丶一丨
耢	未萝ㄋ丿丿丿	未萝ㄋ丿丿丿
耖	未少丨丿丶丿	未少丨丿丶丿
竘	立勹丨ㄋ一一	立勹丨ㄋ一一
麖	鹿京丶一丨ㄋ	鹿京丶一丨ㄋ
枅	木开一一丿丨	木开一一丿丨
梌	木亼一丨丿丶	木亼一丨丿丶
梾	木夹丨丿丶丶	木夹丨丿丶丶
榃	林田丨ㄋ一丨	林田丨ㄋ一丨
榅	木日丨ㄋ丨丨	木日丨ㄋ丨丨
瞫	目西丨ㄋ一一	目西丨ㄋ一一
犏	牛户丨ㄋ一丨	牛户丨ㄋ一丨
妭	女石ㄋ丶丶丶	女石ㄋ丶丶丶
姶	女合丿丶一丨	女合丿丶一丨
婍	女大一丨ㄋ一	女大一丨ㄋ一
婤	女冂一丨一丨	女冂一丨一丨
婫	女日一ㄋ丿ㄋ	女日一ㄋ丿ㄋ
媂	女立丨ㄋ丨丨	女立丨ㄋ丨丨
媓	女白一一丨一	女白一一丨一
媖	女艹丨ㄋ一丿	女艹丨ㄋ一丿
氕	气笔丿丿丿丿	气笔丿丿丿丿
昡	日亠ㄋㄋ丶丶	日亠ㄋㄋ丶丶
晊	日至一ㄋ丶一	日至一ㄋ丶一
泂	氵冂丨ㄋ一一	氵冂丨ㄋ一一
泃	氵勹丨ㄋ一一	氵勹丨ㄋ一一
洈	氵厃ㄋㄋㄋㄋ	氵厃ㄋㄋㄋㄋ
溍	氵亚丨ㄋ一一	氵亚丨ㄋ一一
漈	氵一一丨丿	氵祭一一丨丿
酅	山隹丨ㄋ丿丶	山隹丨ㄋ丿丶
崌	山尸一丨丨ㄋ	山尸一丨丨ㄋ
嵅	山戊一丨ㄋ一	山戊一丨ㄋ一
嵖	山木丨ㄋ一一	山木丨ㄋ一一
嶍	山羽丿丨ㄋ一	山羽丿丨ㄋ一
嶦	山厃丿丶丶一	山厃丿丶丶一
砄	石匚丿丶丶丶	石匚丿丶丶丶
禚	衤羊丶丶丶丶	衤羊丶丶丶丶
祋	衤殳丿ㄋㄋ丶	衤殳丿ㄋㄋ丶
禤	衤四ㄋ丶一ㄋ	衤四ㄋ丶一ㄋ
祾	衤土丿丶丿ㄋ	衤土丿丶丿ㄋ
罶	四留丨ㄋ一丨	四留丨ㄋ一丨
撖	扌㇉一丨丨一	扌Z一丨丨一
扽	扌屯一ㄋ丨ㄋ	扌屯一ㄋ丨ㄋ
揳	扌丰ㄋ丿一丿	扌丰ㄋ丿一丿
疁	田羽丿丶丿丿	田羽丿丶丿丿
鹝	鬲鸟丿ㄋ丶ㄋ	鬲鸟丿ㄋ丶ㄋ
玹	王亠ㄋㄋ丶丶	王亠ㄋㄋ丶丶
珸	王五丨ㄋ一一	王五丨ㄋ一一
瑂	王尸丨ㄋ一一	王尸丨ㄋ一一
瑅	王是丨ㄋ一一	王是丨ㄋ一一
瑔	王白丨ㄋ丿丶	王白丨ㄋ丿丶
瑝	王白一一丨一	王白一一丨一
瓀	王一丿丨ㄋ	王一丿丨ㄋ
釐	未文一丿丨ㄋ	未文一丿丨ㄋ
郚	五口ㄋ丨丨丨	五口ㄋ丨丨丨
歅	西土丿ㄋ丿丶	西土丿ㄋ丿丶
邘	于耳ㄋ丨丨丨	于耳ㄋ丨丨丨
鄑	亚日ㄋ丨丨丨	亚日ㄋ丨丨丨
褯	衤广一丨丨一	衤广一丨丨一
厾	乙去一丨一ㄋ	乙去一丨一ㄋ
鳆	鱼丨ㄋ一一	鱼丨ㄋ一一
鲺	鱼乙丿丨ㄋ一	鱼乙丿丨ㄋ一
鳡	鱼戊一丨ㄋ一	鱼戊一丨ㄋ一
鱾	鱼巴ㄋ一ㄋㄋ	鱼巴ㄋ一ㄋㄋ
鄃	亼月丨丨ㄋ丨	亼月丨丨ㄋ丨
勠	羽人丿丿丿ㄋ	羽人丿丿丿ㄋ
霨	尸一一丨丿	尸一一丨丿
脎	月乂一丨丿丶	月乂一丨丿丶
膪	月立丨ㄋ丨丨	月立丨ㄋ丨丨
腨	月山一丿丨ㄋ	月山一丿丨ㄋ
脟	月爪一丨丶丶	月爪一丨丶丶
胈	月石ㄋ丶丶丶	月石ㄋ丶丶丶
鸼	舟鸟丿ㄋ丶ㄋ	舟鸟丿ㄋ丶ㄋ
鄀	艹石丨ㄋ一ㄋ	艹石丨ㄋ一ㄋ
鼒	㇉目ㄋ一丿丨	Z目ㄋ一丿丨
辿	山辶丶ㄋ丶丶	山辶丶ㄋ丶丶
貆	豸笔丨ㄋ一一	豸笔丨ㄋ一一
莝	艹从一丨一一	艹从一丨一一
羓	羊巴ㄋ丨一ㄋ	羊巴ㄋ丨一ㄋ
羱	羊广丿丨ㄋ一	羊广丿丨ㄋ一
荁	艹笔丨ㄋ一一	艹笔丨ㄋ一一
鄌	广聿丨ㄋ一ㄋ	广聿丨ㄋ一ㄋ
砠	石目丨ㄋ一一	石目丨ㄋ一一
蚆	虫巴ㄋ丨一ㄋ	虫巴ㄋ丨一ㄋ
豮	豕十一丨丨丨	豕十一丨丨丨
陑	耳而一丿丨ㄋ	耳而一丿丨ㄋ
盷	目勹丶一一一	目勹丶一一一
翷	米歹一ㄋ丨ㄋ	米歹一ㄋ丨ㄋ
乸	也母ㄋㄋ丶一	也母ㄋㄋ丶一
佁	亻厶丨ㄋ一一	亻厶丨ㄋ一一
佸	亻舌丿一丨丨	亻舌丿一丨丨
倻	亻耳ㄋ丨丨丨	亻耳ㄋ丨丨丨
偡	亻其ㄋㄋㄋㄋ	亻其ㄋㄋㄋㄋ
僔	亻酋一丨丶丶	亻酋一丨丶丶
凘	冫其丿丿一丨	冫其丿丿一丨
剅	豆刂丨丨丨丨	豆刂丨丨丨丨
剋	古儿丨丨丨丨	古儿丨丨丨丨
呇	水口丨ㄋ一一	水口丨ㄋ一一
哃	口冂一丨ㄋ一	口冂一丨ㄋ一
唝	口工丨ㄋ丿丶	口工丨ㄋ丿丶
圐	口四丶一ㄋ丿	口四丶一ㄋ丿
圙	口八一丿丨ㄋ	口八一丿丨ㄋ
圢	土于一丨丨丨	土于一丨丨丨
圲	土舌丿一丨丨	土舌丿一丨丨
坒	比土一丨一一	比土一丨一一
坽	土令丿丶丶ㄋ	土令丿丶丶ㄋ
垙	土光丨丶丿一	土光丨丶丿一
垵	土宀ㄋ丿一一	土宀ㄋ丿一一
埌	土笔ㄋ一一ㄋ	土笔ㄋ一一ㄋ
埪	土穴一丨一一	土穴一丨一一
堌	土口一丨丨ㄋ	土口一丨丨ㄋ
堧	土而一丿丶丶	土而一丿丶丶
堼	圭寸一丨一一	圭寸一丨一一
堽	土四一丨一丨	土四一丨一丨
墘	土一丿ㄋㄋ	土一丿ㄋㄋ
妘	女云一一ㄋ丶	女云一一ㄋ丶
姈	女令丿丶丶ㄋ	女令丿丶丶ㄋ
婻	女十丨ㄋ丶丿	女十丨ㄋ丶丿
屾	山山丨ㄋ丨丨	山山丨ㄋ丨丨
峂	山文丶丶丶丶	山文丶丶丶丶
峱	犬丑丨ㄋ丨丨	犬丑丨ㄋ丨丨
崡	山了丶一丿丶	山了丶一丿丶
嶅	敖山丨ㄋ丨丨	敖山丨ㄋ丨丨
嶟	山酋一丨丶丶	山酋一丨丶丶
庤	广土一丨丶丶	广土一丨丶丶
廙	广田一丨丨一	广田一丨丨一
悈	忄戋一丿丨丨	忄戋一丿丨丨
愭	忄者丿ㄋ丨ㄋ	忄者丿ㄋ丨ㄋ
慥	忄告丶ㄋ丶丶	忄告丶ㄋ丶丶
慬	忄堇一丨丨一	忄堇一丨丨一
憕	忄一丨ㄋ一	忄祭一丨ㄋ一
戭	宀笔丨ㄋ一丨	宀笔丨ㄋ一丨
挓	扌宀丿一ㄋㄋ	扌宀丿一ㄋㄋ
旵	日山丨ㄋ丨丨	日山丨ㄋ丨丨
旿	日一丨丨丨	日一丨丨丨
昄	日广ㄋ丶丶丶	日广ㄋ丶丶丶
昤	日令丿丶丶ㄋ	日令丿丶丶ㄋ
昪	日厶一丿丨丨	日厶一丿丨丨
晅	日笔丨ㄋ一一	日笔丨ㄋ一一
晱	日火丶丿丿丶	日火丶丿丿丶
暅	日忄一丨ㄋ一	日忄一丨ㄋ一
暕	日束丶丶丶丶	日束丶丶丶丶
暲	日音一丨丨丨	日音一丨丨丨
杧	木亡丶一ㄋㄋ	木亡丶一ㄋㄋ
枍	木八一ㄋㄋㄋ	木八一ㄋㄋㄋ
柖	木刀丨ㄋ一一	木刀丨ㄋ一一
栐	木笔ㄋㄋ丿丶	木笔ㄋㄋ丿丶
栴	木丨ㄋ丶一	木丨ㄋ丶一
梣	木山丿丶丶ㄋ	木山丿丶丶ㄋ
椪	木䒑丨丨丶丿	木首丨丨丶丿
楪	木甘ㄋ一丨丿	木甘ㄋ一丨丿
櫆	木鬼丶丶一丨	木鬼丶丶一丨
毌	母ㄋㄋ一丨丨	母ㄋㄋ一丨丨
汈	氵㇉一一一一	氵Z一一一一
汫	氵二一一丿丨	氵二一一丿丨
沇	氵厶丿ㄋㄋㄋ	氵厶丿ㄋㄋㄋ
沘	氵比一ㄋ丿ㄋ	氵比一ㄋ丿ㄋ
洢	氵亻ㄋ一一丿	氵亻ㄋ一一丿
洨	氵六丿丶丶丶	氵六丿丶丶丶
洭	氵匚一一丨一	氵匚一一丨一
浛	氵令丨ㄋ一一	氵令丨ㄋ一一
浟	氵亻丿一丿丶	氵亻丿一丿丶
浭	氵更一丨ㄋ一	氵更一丨ㄋ一
浲	氵文一一一丨	氵文一一一丨
涍	氵者ㄋ丨一一	氵者ㄋ丨一一
涐	氵我丿一丨一	氵我丿一丨一
涢	氵口丨ㄋ丿丶	氵口丨ㄋ丿丶
淯	氵亡丨ㄋ一一	氵亡丨ㄋ一一
渼	氵羊一丿丶丶	氵羊一丿丶丶
湝	氵比丿丨ㄋ一	氵比丿丨ㄋ一
湣	氵民丨ㄋ一一	氵民丨ㄋ一一
溇	氵米ㄋ丿一一	氵米ㄋ丿一一
溚	氵艹丿丶一丨	氵艹丿丶一丨
溠	氵羊一丨一一	氵羊一丨一一
溵	氵广ㄋ一一丿	氵广ㄋ一一丿
滍	氵山一丨ㄋ一	氵山一丨ㄋ一
漴	氵山丶丶ㄋ一	氵山丶丶ㄋ一
漷	氵ㄋ丨一ㄋ	氵ㄋ丨一ㄋ
漹	氵正ㄋ一丶丶	氵正ㄋ一丶丶
潖	氵王一一丨一	氵王一一丨一
潵	氵共丨ㄋ一一	氵共丨ㄋ一一
潽	氵䒑丨丨丶丿	氵首丨丨丶丿
澭	氵亠ㄋㄋ丿丿	氵亠ㄋㄋ丿丿
瀔	氵一丿ㄋㄋ	氵一丿ㄋㄋ
瀱	氵四一丿丶丿	氵四一丿丶丿
灈	氵目丨ㄋ一一	氵目丨ㄋ一一
炌	火人丿丨丨丨	火人丿丨丨丨
炣	火可一丨ㄋ一	火可一丨ㄋ一
煁	火其ㄋㄋㄋㄋ	火其ㄋㄋㄋㄋ
煃	火大一丨一一	火大一丨一一
熜	火丿ㄋ丶一	火丿ㄋ丶一
熥	火甬丶ㄋ丶丶	火甬丶ㄋ丶丶
熻	火合ㄋ丶一ㄋ	火合ㄋ丶一ㄋ
燚	火火丶丿丿丶	火火丶丿丿丶
爔	火羊一丨丿丶	火羊一丨丿丶
牥	牛方丶一ㄋ丿	牛方丶一ㄋ丿
玒	王工一丨一一	王工一丨一一
玓	王勹丶丶丶丶	王勹丶丶丶丶
玶	王平一丶丿一	王平一丶丿一
玿	王刀丨ㄋ一一	王刀丨ㄋ一一
珇	王目丨ㄋ一一	王目丨ㄋ一一
珒	王聿ㄋ一一一	王聿ㄋ一一一
珕	王力ㄋ丿ㄋ丿	王力ㄋ丿ㄋ丿
珖	王光丨丶丿一	王光丨丶丿一
珦	王丨ㄋ一一	王丨ㄋ一一
珵	王口一一丨一	王口一一丨一
珹	王戊ㄋㄋㄋㄋ	王戊ㄋㄋㄋㄋ
琀	王令丨ㄋ一一	王令丨ㄋ一一
琎	王二丶ㄋ丶丶	王二丶ㄋ丶丶
琔	王定丶丶ㄋ一	王定丶丶ㄋ一
琟	王隹丿丨丶一	王隹丿丨丶一
琡	王上丨丿丶ㄋ	王上丨丿丶ㄋ
瑃	王丨ㄋ一一	王丨ㄋ一一
瑆	王日丿一一丨	王日丿一一丨
瑖	王段丿丨一一	王段丿丨一一
瑬	氵亡丿丨ㄋ一	氵亡丿丨ㄋ一
璒	王一丨ㄋ一	王祭一丨ㄋ一
璥	王艹丿ㄋ丨ㄋ	王艹丿ㄋ丨ㄋ
璬	王白丶一ㄋ丿	王白丶一ㄋ丿
畖	田爪丿丿ㄋ丶	田爪丿丿ㄋ丶
疭	疒从丿丶丿丶	疒从丿丶丿丶
癗	疒丨ㄋ一丨	疒丨ㄋ一丨
皕	笔白一丿丨ㄋ	笔白一丿丨ㄋ
砵	石木一一一一	石木一一一一
膙	月弓丨ㄋ一丨	月弓丨ㄋ一丨
萳	艹十丨ㄋ丶丿	艹十丨ㄋ丶丿
蔃	艹弓丨ㄋ一丨	艹弓丨ㄋ一丨
薸	落西一一丨丿	落西一一丨丿
觃	见子ㄋ丨一一	见子ㄋ丨一一
陎	耳笔丨丿丶丶	耳笔丨丿丶丶
齉	自田一丨ㄋ一	自田一丨ㄋ一
慓	忄西一一丨丿	忄西一一丨丿
琍	王禾丨丨丨丨	王禾丨丨丨丨
蠧	石丨ㄋ一丨	石丨ㄋ一丨
歔	虍业丿ㄋ丿丶	虍业丿ㄋ丿丶
誌	讠土丶ㄋ丶丶	讠土丶ㄋ丶丶
砢	石可一丨ㄋ一	石可一丨ㄋ一
頔	甲石丨ㄋ一一	甲石丨ㄋ一一
娭	女厶丿一一丿	女厶丿一一丿
嘢	口田ㄋ丶ㄋ丨	口田ㄋ丶ㄋ丨
袴	衤大一一ㄋㄋ	衤大一一ㄋㄋ
毑	母也ㄋ丨ㄋㄋ	母也ㄋ丨ㄋㄋ
觍	甲八丨ㄋ丿ㄋ	甲八丨ㄋ丿ㄋ
坉	土屯一ㄋ丨ㄋ	土屯一ㄋ丨ㄋ
䣘	土ㄋ丨丨丨	土ㄋ丨丨丨
鹐	鱼鼠丿ㄋ丶ㄋ	鱼鼠丿ㄋ丶ㄋ
䢼	共耳ㄋㄋ丨丨	共耳ㄋㄋ丨丨
䎖	曾羽ㄋ丶一ㄋ	曾羽ㄋ丶一ㄋ
戣	天一ㄋ丿丶	祭天一ㄋ丿丶
劐	艹隹ㄋ丶丨丨	艹隹ㄋ丶丨丨
葴	艹戊一丨ㄋ一	艹戊一丨ㄋ一
苧	艹宀一丨丨丨	艹宀一丨丨丨
莿	艹朿丨丨丨丨	艹朿丨丨丨丨
蒄	萝元一丨丶丶	萝元一丨丶丶
䓨	萝缶丿一一丨	萝缶丿一一丨
䓫	艹大一丨ㄋ一	艹大一丨ㄋ一
徛	彳大一丨ㄋ一	彳大一丨ㄋ一
虷	虫舌一一丨丨	虫舌一一丨丨
鬶	夫见一丨ㄋ一	夫见一丨ㄋ一
㺄	犬亼丨ㄋ一一	犬亼丨ㄋ一一
旞	族冫一丿ㄋ丿	族冫一丿ㄋ丿
庱	广土丿丶丿ㄋ	广土丿丶丿ㄋ
馧	禾日丨ㄋ一一	禾日丨ㄋ一一
穙	禾业丶丿一一	禾业丶丿一一
馝	禾日丶ㄋ丶丶	禾日丶ㄋ丶丶
䅟	禾厶丿丿丿丿	禾厶丿丿丿丿
焆	火口丨ㄋ一一	火口丨ㄋ一一
煓	火山一丿丨ㄋ	火山一丿丨ㄋ
彐	尹ㄋ一一一一	尹ㄋ一一一一
䌹	纟冂丨ㄋ一一	纟冂丨ㄋ一一
䥽	金发ㄋ丿ㄋ丶	金发ㄋ丿ㄋ丶
鼱	鼠青一一丨一	鼠青一一丨一
䶮	龙天一一丿丶	龙天一一丿丶
毪	毛厶丿一一丨	毛厶丿一一丨
鄚	莫耳ㄋ丨丨丨	莫耳ㄋ丨丨丨
㭕	木去一丨一ㄋ	木去一丨一ㄋ
棤	木共丨ㄋ一一	木共丨ㄋ一一
椆	木冂一丨一丨	木冂一丨一丨
檞	木角ㄋ丿丿一	木角ㄋ丿丿一
㛚	女甬ㄋ丶丨ㄋ	女甬ㄋ丶丨ㄋ
䢺	山冂ㄋ丨丨丨	山冂ㄋ丨丨丨
䴖	青鸟丿ㄋ丶ㄋ	青鸟丿ㄋ丶ㄋ
昣	日人丿丿丿丿	日人丿丿丿丿
漤	氵林ㄋ丿一一	氵林ㄋ丿一一
瀌	氵鹿丶丶丶丶	氵鹿丶丶丶丶
饻	食衣丶一丿ㄋ	食衣丶一丿ㄋ
硔	石共一丨丨一	石共一丨丨一
㥄	忄土丿丶丿ㄋ	忄土丿丶丿ㄋ
邿	土寸ㄋ丨丨丨	土寸ㄋ丨丨丨
璮	王亠丨ㄋ丨ㄋ	王亠丨ㄋ丨ㄋ
鳤	鱼丶丶ㄋ丨	鱼丶丶ㄋ丨
鲘	鱼广一丨ㄋ一	鱼广一丨ㄋ一
翯	羽丨ㄋ一一	羽丨ㄋ一一
舥	舟巴ㄋ丨一ㄋ	舟巴ㄋ丨一ㄋ
碈	石氏丨ㄋ一一	石氏丨ㄋ一一
禒	衤彑丿ㄋ丿丿	衤彑丿ㄋ丿丿
胣	月ㄋ丨ㄋㄋ	月ㄋ丨ㄋㄋ
㑇	亻刍丿ㄋㄋ一	亻刍丿ㄋㄋ一
㑊	亻亦丶一丿丨	亻亦丶一丿丨
㕮	口父丿丶丿丶	口父丿丶丿丶
㘎	口门ㄋ一丨丨	口门ㄋ一丨丨
㙍	土双ㄋ丶ㄋ丶	土双ㄋ丶ㄋ丶
㙘	土西ㄋ丿一一	土西ㄋ丿一一
㙦	亼木丶丶一丨	亼木丶丶一丨
㛃	丰刀ㄋ丿一一	丰刀ㄋ丿一一
㛹	女亻一丨ㄋ一	女亻一丨ㄋ一
㟃	山㇉一丨ㄋ一	山Z一丨ㄋ一
㠇	山京一丿ㄋ丶	山京一丿ㄋ丶
㠓	山萝一一丿ㄋ	山萝一一丿ㄋ
㤘	忄刍丿ㄋㄋ一	忄刍丿ㄋㄋ一
㧐	扌双ㄋ丶ㄋ丶	扌双ㄋ丶ㄋ丶
㧑	扌笔ㄋ丿丶丶	扌笔ㄋ丿丶丶
㧟	扌氵一ㄋㄋㄋ	扌氵一ㄋㄋㄋ
㫰	日笔ㄋ一一ㄋ	日笔ㄋ一一ㄋ
㬊	日爪一一丿ㄋ	日爪一一丿ㄋ
㬎	日幺ㄋㄋ丶丶	日幺ㄋㄋ丶丶
㬚	日亡丨ㄋ一一	日亡丨ㄋ一一
㭎	木冂丿丶丶丶	木冂丿丶丶丶
㮾	笔丿ㄋ一一	笔丿ㄋ一一
㰀	木禾丿ㄋ丨丶	木禾丿ㄋ丨丶
㳇	氵父丿丶丿丶	氵父丿丶丿丶
㳘	氵亡丿ㄋㄋㄋ	氵亡丿ㄋㄋㄋ
㳚	氵戊丶丶丶丶	氵戊丶丶丶丶
㴔	氵刍丶ㄋ丶丶	氵刍丶ㄋ丶丶
㵐	水广丶丿一ㄋ	水广丶丿一ㄋ
㶲	火甬丿ㄋ一一	火甬丿ㄋ一一
㸆	火告丨一一一	火告丨一一一
㸌	火丿丨丶一	火丿丨丶一
㻬	王一一ㄋㄋ	王一一ㄋㄋ
㽏	氵合一丨丨一	氵合一丨丨一
㿠	白光丨丶丿一	白光丨丶丿一
䁖	目米ㄋ丿一一	目米ㄋ丿一一
䂮	丰刀一丿丨ㄋ	丰刀一丿丨ㄋ
䃅	石单丶丿丨ㄋ	石单丶丿丨ㄋ
䃎	石大丿ㄋ丶丿	石大丿ㄋ丶丿
䎃	冂土ㄋ丶一ㄋ	冂土ㄋ丶一ㄋ
䏝	月二ㄋ丶丶丶	月二ㄋ丶丶丶
䏡	月示一一丨丿	月示一一丨丿
䏲	月弓丶丿ㄋ一	月弓丶丿ㄋ一
䐃	月口一丨丿丶	月口一丨丿丶
䓖	艹穴ㄋ丿丿丿	艹穴ㄋ丿丿丿
䓛	艹尸ㄋ丨丨ㄋ	艹尸ㄋ丨丨ㄋ
䓬	艹卜丨ㄋ一一	艹卜丨ㄋ一一
䕫	艹白丨一丨一	艹白丨一丨一
䗖	虫艹丶ㄋ丨ㄋ	虫艹丶ㄋ丨ㄋ
䗛	虫亻丨丿ㄋ一	虫亻丨丿ㄋ一
䗪	度双丶丶丶丶	度双丶丶丶丶
䗴	虫丿一丨一	虫丿一丨一
䜣	讠丘丿丿一丨	讠丘丿丿一丨
䝙	豸区一丿丶ㄋ	豸区一丿丶ㄋ
䦃	金艹一丨一丿	金艹一丨一丿
䲟	鱼留一ㄋ丨丨	鱼留一ㄋ丨丨
䲠	鱼丨ㄋ一一	鱼丨ㄋ一一
䲢	月丿ㄋ丨ㄋ	月丿ㄋ丨ㄋ
䴓	笔巾丿ㄋ丶ㄋ	笔巾丿ㄋ丶ㄋ
䴔	六乂丿ㄋ丶ㄋ	六乂丿ㄋ丶ㄋ
䴕	歹刂丿ㄋ丶ㄋ	歹刂丿ㄋ丶ㄋ
䴗	日犬丿ㄋ丶ㄋ	日犬丿ㄋ丶ㄋ
䴘	广虍丿ㄋ丿ㄋ	广虍丿ㄋ丿ㄋ
䴙	辟鸟丿ㄋ丶ㄋ	辟鸟丿ㄋ丶ㄋ
侴	亼笔ㄋ丨一一	亼笔ㄋ丨一一
傃	亻丰ㄋㄋ丶丨	亻丰ㄋㄋ丶丨
叕	双双ㄋ丶ㄋ丶	双双ㄋ丶ㄋ丶
咉	口冂一丿丶丶	口冂一丿丶丶
圫	土笔一ㄋㄋㄋ	土笔一ㄋㄋㄋ
坥	土目丨ㄋ一一	土目丨ㄋ一一
垈	代土一丨一一	代土一丨一一
垏	土聿ㄋ一一一	土聿ㄋ一一一
垺	土爪ㄋ丨一一	土爪ㄋ丨一一
垾	土日一一丨丨	土日一一丨丨
垿	土广ㄋ丶ㄋ丨	土广ㄋ丶ㄋ丨
埫	土丨ㄋ丨ㄋ	土丨ㄋ丨ㄋ
堐	土广一丨一一	土广一丨一一
堾	土丨ㄋ一一	土丨ㄋ一一
塱	笔丿ㄋ一一	笔丿ㄋ一一
墕	土正ㄋ一丶丶	土正ㄋ一丶丶
墡	土羊丶丿一丨	土羊丶丿一丨
寁	宀笔ㄋ一一丨	宀笔ㄋ一一丨
峏	山而一丿丨ㄋ	山而一丿丨ㄋ
峛	山歹丨丨丨丨	山歹丨丨丨丨
崶	山圭一丨丶丶	山圭一丨丶丶
弨	弓刀丨ㄋ一一	弓刀丨ㄋ一一
恔	忄六丿丶丶丶	忄六丿丶丶丶
愃	忄宀一丨ㄋ一	忄宀一丨ㄋ一
愐	忄面一丿丨ㄋ	忄面一丿丨ㄋ
揕	扌其ㄋㄋㄋㄋ	扌其ㄋㄋㄋㄋ
晪	日甲丿丶丶丶	日甲丿丶丶丶
暶	日族ㄋ丨一丿	日族ㄋ丨一丿
暿	日壴丨ㄋ一一	日壴丨ㄋ一一
朸	木力ㄋ丿丿丿	木力ㄋ丿丿丿
杄	木舌丿一丨丨	木舌丿一丨丨
栒	木勹丨ㄋ一一	木勹丨ㄋ一一
棪	木火丶丿丿丶	木火丶丿丿丶
楒	木田丶ㄋ丶丶	木田丶ㄋ丶丶
槜	木隹ㄋ丿丿丿	木隹ㄋ丿丿丿
橞	木笔丨ㄋ一一	木笔丨ㄋ一一
泇	氵加ㄋ丿丨ㄋ	氵加ㄋ丿丨ㄋ
洓	氵朿一丨ㄋ丨	氵朿一丨ㄋ丨
洘	氵者一ㄋㄋㄋ	氵者一ㄋㄋㄋ
洣	氵米丶丿一丨	氵米丶丿一丨
涄	氵甲一ㄋㄋㄋ	氵甲一ㄋㄋㄋ
溁	氵萝一丨丿丶	氵萝一丨丿丶
溹	氵ㄋㄋ丶丨	氵ㄋㄋ丶丨
滧	氵六丿丶丿一	氵六丿丶丿一
漋	氵耳丿ㄋ丶丿	氵耳丿ㄋ丶丿
漖	氵者ㄋ丨一丿	氵者ㄋ丨一丿
潩	氵田一丨丨一	氵田一丨丨一
澪	氵丿丶丶ㄋ	氵丿丶丶ㄋ
澽	氵虍一丿ㄋ丿	氵虍一丿ㄋ丿
濋	氵林ㄋ丨一丿	氵林ㄋ丨一丿
烠	火石丨ㄋ一一	火石丨ㄋ一一
煋	火日丿一一丨	火日丿一一丨
牻	牛尢丿丿丿丶	牛尢丿丿丿丶
玤	王丰一一一丨	王丰一一一丨
珋	王留丿ㄋ丿ㄋ	王留丿ㄋ丿ㄋ
珛	王石丨ㄋ一一	王石丨ㄋ一一
珢	王艮ㄋ一一ㄋ	王艮ㄋ一一ㄋ
琈	王爪ㄋ丨一一	王爪ㄋ丨一一
瑓	王束丶丶丶丶	王束丶丶丶丶
瑧	王一丨丿丶	王一丨丿丶
璱	王王一一丨一	王王一一丨一
癿	白乙ㄋㄋㄋㄋ	白乙ㄋㄋㄋㄋ
苉	艹匚丿ㄋㄋㄋ	艹匚丿ㄋㄋㄋ
茋	艹氏丶丶丶丶	艹氏丶丶丶丶
萣	艹定丶丶ㄋ一	艹定丶丶ㄋ一
蚲	虫平一丶丿一	虫平一丶丿一
馞	禾日一丨丶ㄋ	禾日一丨丶ㄋ
鹲	萝笔一丿ㄋ丿	萝笔一丿ㄋ丿
粬	米甲丨ㄋ一丨	米甲丨ㄋ一丨
𬉼	火区一丿丶ㄋ	火区一丿丶ㄋ
𠳐	口丰ㄋ丨丨丨	口丰ㄋ丨丨丨
𥻗	米木丨ㄋ一一	米木丨ㄋ一一
𠙶	了冂ㄋ丨丨丨	了冂ㄋ丨丨丨
𬣙	讠于一一丨丨	讠于一一丨丨
𨙸	十双ㄋ丨丨丨	十双ㄋ丨丨丨
𬇕	氵力一ㄋ丿丿	氵力一ㄋ丿丿
𬣞	讠宀一一一一	讠宀一一一一
𬘓	纟川丿丨丨丨	纟川丿丨丨丨
𫭟	土区一丿丶ㄋ	土区一丿丶ㄋ
𫭢	土人丿ㄋㄋㄋ	土人丿ㄋㄋㄋ
𫇭	艹笔ㄋ丿丶丶	艹笔ㄋ丿丶丶
𫐄	车笔丿ㄋㄋㄋ	车笔丿ㄋㄋㄋ
𫵷	山广一ㄋ丿丿	山广一ㄋ丿丿
𣲘	氵笔一丿ㄋㄋ	氵笔一丿ㄋㄋ
𣲗	氵韦一一ㄋ丨	氵韦一一ㄋ丨
𬇙	氵贝丨ㄋ丿丶	氵贝丨ㄋ丿丶
𬣡	讠戋一一ㄋ丿	讠戋一一ㄋ丿
𫸩	弓区一丿丶ㄋ	弓区一丿丶ㄋ
𨚕	厶开ㄋ丨丨丨	厶开ㄋ丨丨丨
𫘜	马文丶一丿丶	马文丶一丿丶
𬘘	纟冖丿ㄋㄋㄋ	纟冖丿ㄋㄋㄋ
𫘝	马匚丿丶丶丶	马匚丿丶丶丶
𦭜	艹口丿丶丶丶	艹口丿丶丶丶
𬨂	车氏丿ㄋ一ㄋ	车氏丿ㄋ一ㄋ
𬀩	日韦一一ㄋ丨	日韦一一ㄋ丨
𬀪	日见丨ㄋ丿ㄋ	日见丨ㄋ丿ㄋ
𬬩	金戋一ㄋ丶丶	金戋一ㄋ丶丶
𫍣	讠冂一丨ㄋ一	讠冂一丨ㄋ一
𬣳	讠艮ㄋ一一ㄋ	讠艮ㄋ一一ㄋ
𬩽	尹寸ㄋ丨丨丨	尹寸ㄋ丨丨丨
𬮿	耳巴丿ㄋㄋㄋ	耳巴丿ㄋㄋㄋ
𬯀	耳文丿丨丨丨	耳文丿丨丨丨
𫰛	女轻ㄋ丶一丨	女轻ㄋ丶一丨
𬳵	马不一一一一	马不一一一一
𬳶	马冂丨ㄋ一一	马冂丨ㄋ一一
𫠊	马亠ㄋㄋ丶丶	马亠ㄋㄋ丶丶
𬍛	王留丨丿丶丶	王留丨丿丶丶
鿍	土文一ㄋ丨丨	土文一ㄋ丨丨
𬜬	艹门丨ㄋ一一	艹门丨ㄋ一一
𦰡	艹刀ㄋ丨丨丨	艹刀ㄋ丨丨丨
𪾢	目见丨ㄋ丿ㄋ	目见丨ㄋ丿ㄋ
𪨰	山甲丨ㄋ一丨	山甲丨ㄋ一丨
𫓧	金夫一一丿丶	金夫一一丿丶
𬬮	金长丿一ㄋ丶	金长丿一ㄋ丶
𬬱	金丘丿丿一丨	金丘丿丿一丨
𬬭	金人丿ㄋㄋㄋ	金人丿ㄋㄋㄋ
𦙶	月古一丨丨ㄋ	月古一丨丨ㄋ
𬘡	纟因丨ㄋ一丿	纟因丨ㄋ一丿
𬳽	马先丿一丨一	马先丿一丨一
𬘩	纟笔丨一丨一	纟笔丨一丨一
𪟝	丰贝ㄋ丿丿丿	丰贝ㄋ丿丿丿
𬍤	王尹一丨丶丶	王尹一丨丶丶
𫭼	土萝ㄋ丿丿丿	土萝ㄋ丿丿丿
𬜯	艹丙丿丶丿丶	艹丙丿丶丿丶
𬂩	木夹丿丶丶丶	木夹丿丶丶丶
𫠆	十双一丿丨ㄋ	十双一丿丨ㄋ
𨐈	车光丨丶丿一	车光丨丶丿一
𬌗	牙合丿丶一丨	牙合丿丶一丨
𫑡	口日ㄋㄋ丨丨	口日ㄋㄋ丨丨
𪨶	山大一ㄋ一丨	山大一ㄋ一丨
𬬸	金木丶丶丶丶	金木丶丶丶丶
𬬻	金卜ㄋ一丿丿	金卜ㄋ一丿丿
𬬹	金日丨丨丨丨	金日丨丨丨丨
𬬿	金刀丨ㄋ一一	金刀丨ㄋ一一
𬭁	金母ㄋㄋ丶一	金母ㄋㄋ丶一
𫢸	亻单丶丿丨ㄋ	亻单丶丿丨ㄋ
𫗧	食束一丨ㄋ一	食束一丨ㄋ一
𬊈	火尹一丨丶丶	火尹一丨丶丶
𬒈	石一丿丨ㄋ	石一丿丨ㄋ
𨺙	耳鼠丿ㄋㄋㄋ	耳鼠丿ㄋㄋㄋ
𬳿	马亼一丨丿丶	马亼一丨丿丶
𫄨	纟乂丨ㄋ丨丨	纟乂丨ㄋ丨丨
𬘫	纟宀一一丿ㄋ	纟宀一一丿ㄋ
𫮃	土单丶丿丨ㄋ	土单丶丿丨ㄋ
鿎	石大丶ㄋ丶丶	石大丶ㄋ丶丶
𬱖	甲页一丿丨ㄋ	甲页一丿丨ㄋ
𬟽	虫车丨丿丶丶	虫车丨丿丶丶
𫓯	金圭一丨一一	金圭一丨一一
𫟹	金共一丨丨一	金共一丨丨一
𫟼	金大丶ㄋ丶丶	金大丶ㄋ丶丶
𠅤	亠田丶ㄋ丶丶	亠田丶ㄋ丶丶
𬇹	氵口一一丨一	氵口一一丨一
𬍡	氵㇉丿丿一一	氵Z丿丿一一
𬤇	讠西一丨一一	讠西一丨一一
𫍯	讠戊一丨ㄋ一	讠戊一丨ㄋ一
𬤊	讠是丨ㄋ一一	讠是丨ㄋ一一
𫍲	讠鼠丨ㄋ丶丶	讠鼠丨ㄋ丶丶
𬯎	耳丨ㄋ丿丶	耳丨ㄋ丿丶
𬘬	纟青一一丨一	纟青一一丨一
𬘭	纟林一丨丿丶	纟林一丨丿丶
𬴂	马非丨一一一	马非丨一一一
𫘦	马勹丿一一丨	马勹丿一一丨
𫟅	纟京丶一丨ㄋ	纟京丶一丨ㄋ
𬘯	纟ㄋ丨一一	纟ㄋ丨一一
𫘧	马尹丨ㄋ丿丶	马尹丨ㄋ丿丶
𪣻	土米ㄋ丿一一	土米ㄋ丿一一
𡎚	土户丨ㄋ一丨	土户丨ㄋ一丨
𬃊	木广一丨丨ㄋ	木广一丨丨ㄋ
𬷕	甫鸟丿ㄋ丶ㄋ	甫鸟丿ㄋ丶ㄋ
𫐐	车鼠丿ㄋㄋㄋ	车鼠丿ㄋㄋㄋ
𬹼	止人丿丨丨丨	止人丿丨丨丨
𧿹	母ㄋㄋ丶一	母ㄋㄋ丶一
𫶇	山艹丶ㄋ丨ㄋ	山艹丶ㄋ丨ㄋ
𫖮	山巴一丿丨ㄋ	山巴一丿丨ㄋ
鿏	金丰丿ㄋ丶丶	金丰丿ㄋ丶丶
𬭊	金木一丨一一	金木一丨一一
𨱇	金求一丨丶一	金求一丨丶一
𫓶	金口丨ㄋ一一	金口丨ㄋ一一
𬭎	金宀一丿ㄋ丶	金宀一丿ㄋ丶
𫖯	儿水一丿丨ㄋ	儿水一丿丨ㄋ
𬱟	厃巴一丿丨ㄋ	厃巴一丿丨ㄋ
𫛭	犬王丿ㄋ丶ㄋ	犬王丿ㄋ丶ㄋ
𫷷	广金丿ㄋ丿丶	广金丿ㄋ丿丶
𬮱	门西一丨一一	门西一丨一一
𬊤	火单丶丿丨ㄋ	火单丶丿丨ㄋ
𣸣	氵十一丨丨丨	氵十一丨丨丨
𬴃	马丰一丿丨ㄋ	马丰一丿丨ㄋ
𫘨	马是丨ㄋ一一	马是丨ㄋ一一
𤧛	王立丨ㄋ丨丨	王立丨ㄋ丨丨
𬪩	西农丶ㄋ丿ㄋ	西农丶ㄋ丿ㄋ
𬒔	石止丨ㄋ一一	石止丨ㄋ一一
𬨎	车酋丶丿一丨	车酋丶丿一丨
𫐓	车矛一丨丿丶	车矛一丨丿丶
𫫇	口亚丶ㄋ丶丶	口亚丶ㄋ丶丶
𫓹	金其一丨丨一	金其一丨丨一
𬭚	金ㄋ丨一一	金ㄋ丨一一
𬭛	金氵ㄋ丿丨ㄋ	金氵ㄋ丿丨ㄋ
𬕂	工丨ㄋ丿丶	工丨ㄋ丿丶
𬶋	鱼勹丨ㄋ一一	鱼勹丨ㄋ一一
𬶍	鱼宀丿ㄋㄋㄋ	鱼宀丿ㄋㄋㄋ
𦝼	月米ㄋ丿一一	月米ㄋ丿一一
𫔶	门自一丨丿丶	门自一丨丿丶
𫌀	衤丰丨ㄋ丿丶	衤丰丨ㄋ丿丶
𫖳	尹口一丿丨ㄋ	尹口一丿丨ㄋ
𫘪	马广丿丨ㄋ一	马广丿丨ㄋ一
𫘬	马爪ㄋㄋ丶一	马爪ㄋㄋ丶一
𫞩	王艹一丨ㄋ丿	王艹一丨ㄋ丿
𡐓	土广ㄋ一一丨	土广ㄋ一一丨
𪤗	土羽丿丶丿丿	土羽丿丶丿丿
𣗋	土丿ㄋㄋㄋ	土丿ㄋㄋㄋ
𬸘	匚日ㄋ丿一丿	匚日ㄋ丿一丿
𬒗	石丨ㄋ丿ㄋ	石丨ㄋ丿ㄋ
𥔲	石吅一一ㄋㄋ	石吅一一ㄋㄋ
𫚖	此鱼丿ㄋ丨ㄋ	此鱼丿ㄋ丨ㄋ
𨱏	金艹丿丶一丨	金艹丿丶一丨
𬭤	金亻ㄋ一丿一	金亻ㄋ一丿一
𫚕	鱼刂一丨ㄋ丨	鱼刂一丨ㄋ丨
𬶐	鱼儿丶一丿丶	鱼儿丶一丿丶
𬶏	鱼厃ㄋㄋㄋㄋ	鱼厃ㄋㄋㄋㄋ
𩽾	鱼宀ㄋ丿一一	鱼宀ㄋ丿一一
𬸚	犬讠一丿丶丶	犬讠一丿丶丶
𬤝	讠笔丨ㄋ一一	讠笔丨ㄋ一一
𬙂	纟宀一丨ㄋ一	纟宀一丨ㄋ一
𬭩	金公ㄋ丶一ㄋ	金公ㄋ丶一ㄋ
𩾃	鱼象丿ㄋㄋㄋ	鱼象丿ㄋㄋㄋ
𬸣	寒鸟丿ㄋ丶ㄋ	寒鸟丿ㄋ丶ㄋ
𫍽	讠四一丨ㄋ一	讠四一丨ㄋ一
𬴊	马米丿ㄋ丶一	马米丿ㄋ丶一
𬞟	艹止丨丿丿一	艹止丨丿丿一
𥕢	石笔丨ㄋ一丨	石笔丨ㄋ一丨
𫟦	车冫一丿ㄋ丿	车冫一丿ㄋ丿
𬺈	止大一丨ㄋ一	止大一丨ㄋ一
𫠜	止鼠丿ㄋㄋㄋ	止鼠丿ㄋㄋㄋ
𪩘	山十丨ㄋ丶丿	山十丨ㄋ丶丿
𬭬	金丰一一一丨	金丰一一一丨
𨱑	金共丨ㄋ一丨	金共丨ㄋ一丨
𬭯	金米丿一丿丶	金米丿一丿丶
𫗴	食亠丨ㄋ丨ㄋ	食亠丨ㄋ丨ㄋ
𬸦	族走丿ㄋ丶ㄋ	族走丿ㄋ丶ㄋ
𫄷	纟音丶ㄋ丶丶	纟音丶ㄋ丶丶
𤩽	王十丨ㄋ丶丿	王十丨ㄋ丶丿
𬭳	金壴丨ㄋ一一	金壴丨ㄋ一一
𬭶	金黑丨ㄋ丶丿	金黑丨ㄋ丶丿
𫔍	金釆丨ㄋ一丨	金釆丨ㄋ一丨
𬭸	金米丿ㄋ丶一	金米丿ㄋ丶一
𨱔	金酋一丨丶丶	金酋一丨丶丶
𬭼	金冫一丿ㄋ丿	金冫一丿ㄋ丿
𫔎	金矛丨ㄋ丿丶	金矛丨ㄋ丿丶
𬸪	釆田丿ㄋ丶ㄋ	釆田丿ㄋ丶ㄋ
𬶟	鱼束丨丨丨丨	鱼束丨丨丨丨
𬶠	鱼束丶丶丶丶	鱼束丶丶丶丶
𬶨	旡丿ㄋ丨ㄋ	旡丿ㄋ丨ㄋ
𦈡	纟一丿丨ㄋ	纟一丿丨ㄋ
𫄸	纟舌丨ㄋ丶丿	纟舌丨ㄋ丶丿
𬟁	艹鬲丿ㄋ丶ㄋ	艹鬲丿ㄋ丶ㄋ
𥖨	石口丨ㄋ一丨	石口丨ㄋ一丨
𦒍	立田ㄋ丶一ㄋ	立田ㄋ丶一ㄋ
𬙊	纟黑一丨一一	纟黑一丨一一
𬶭	鱼一一丨丿	鱼祭一一丨丿
𩾌	鱼广ㄋ一一丨	鱼广ㄋ一一丨
𨟠	目目丿丨丶一	目目丿丨丶一
𬶮	鱼壴丨ㄋ一一	鱼壴丨ㄋ一一
𨭉	文笔一ㄋ丶丿	文笔一ㄋ丶丿
𬙋	纟亠丨ㄋ一丨	纟亠丨ㄋ一丨
𤫉	王火丶一一一	王火丶一一一
𬺓	止林ㄋ丨一丿	止林ㄋ丨一丿
𫚭	鱼川丨ㄋ一ㄋ	鱼川丨ㄋ一ㄋ
屄	尸穴丶丶ㄋ丿	尸穴丶丶ㄋ丿
逎	西辶丶ㄋ丶丶	西辶丶ㄋ丶丶